#######################
##
## License goes here
##
#######################
a	ɑ
aacht	aːχt
aachtafofzeg	aːʁdɑfoftsəɕ
aachtandrësseg	aːχtɑndʀəsəɕ
aachte	aːχtə
aachten	aːχtən
aangel	aːŋəl
aangelkreepche	aːŋəlkʀeːpɕə
aangelkreepchen	aːŋəlkʀeːpɕən
aarbecht	aːɐbəɕt
aarbechter	aːɐbəɕtɐ
aarbechterinne	aːɐbəɕtəʀinə
aarbechtsamt	aːɐbəɕtsɑmt
aarbechtsämter	aːɐbəɕtsæmtɐ
aarbechtskolleeginne	aːɐbəɕtskoleːʑinə
aarbechtskolleg	aːɐbəɕtskoleːɕ
aarbechtskolleginne	aːɐbəɕtskoleːʑinə
aarbechtslost	aːɐbəɕtsloːst
aarbechtsministär	aːɐbəɕtsministɛːʀ
aarbechtsministère	aːɐbəɕtsministɛːʀ
aarbechtsplaz	aːɐbəɕtsplaːts
aarbechtszäit	aːɐbəɕtstsæːɪt
aarm	aːɐm
aarmbandauer	aːɐmbɑndɑʊɐ
aarme	aːʀmə
aarmséileg	aːɐmsɜɪləɕ
aarmutsituatiounen	aːɐmutzitwatsjəʊnən
aarmutsrisiko	aːɐmutsʀizikoː
aarmutt	aːɐmut
aart	aːʀt
aartlech	aːʀtləɕ
aascht	aːʃt
aaxt	aːkst
abatjour	ɑbaːʒuːʀ
abattement	ɑbɑtəmɑ̃ː
abattemente	ɑbɑtəmɑ̃ːə
abattementen	ɑbɑtəmɑ̃ːən
abberzuel	ɑbɐtsuəl
abc	aːbeːtseː
abee	ɑbeː
abegräife	ɑbəgʀæːɪfə
abegräifen	ɑbəgʀæːɪfən
abendmahl	aːbəntmaːl
abenteuer	aːbəntoɪɐ
abezuele	ɑbətsuələ
abezuelen	ɑbətsuələn
abgöttesch	ɑbgøtəʃ
abiméiere	ɑbimɜɪəʀə
abiméieren	ɑbimɜɪəʀən
abléck	ɑblek
abonnentinne	ɑbonæntinə
abrëll	ɑbʀəl
abrëllsgeck	ɑbʀəlsgæk
abriecherinne	ɑbʀiəɕəʀinə
abroch	ɑbʀoχ
abscheilech	ɑpʃɑɪləɕ
absenteismus	ɑbzænteːismus
absichtlech	ɑpziɕtləɕ
absolutt	ɑpzolut
absolventinne	ɑbzolvæntinə
abstraéiert	ɑbstʀɑɜɪɐt
abstraéiertes	ɑbstʀɑɜɪɐtəs
abstrakt	ɑbstʀɑkt
absurd	ɑpzuʀt
äbtissinne	æptisinə
abus	ɑbyː
abuse	ɑbyːə
abusen	ɑbyːən
acceleratioun	ɑkseləʀatsjəʊn
acceleratiounen	ɑksæləʀatsjəʊnən
acceleréier	ɑkseləʀɜɪɐ
acceleréiere	ɑkseləʀɜɪəʀə
accent	ɑksɑ̃ː
accentuéier	ɑksɑ̃ːtyɜɪɐ
accentuéiere	ɑksɑ̃ːtyɜɪəʀə
accentuéieren	ɑksɑ̃ːtyɜɪəʀən
accès	ɑksɛː
accèse	ɑksɛːə
accèsen	ɑksɛːən
accessibeles	ɑksæsibələs
accident	ɑksidænt
accisë	ɑksiːzə
accisen	ɑksiːzən
accord	ɑkɔːʀ
accouchéiere	ɑkuʃɜɪəʀə
accouchéieren	ɑkuʃɜɪəʀən
accouchement	ɑkuʃəmænt
accroc	ɑkʀoː
accueil	ɑkœj
accueile	ɑkœjə
accueilen	ɑkœjən
accumuléiere	ɑkymylɜɪəʀə
accumuléieren	ɑkymylɜɪəʀən
achterbunn	ɑχtɐbun
achtkanteges	ɑχtkɑntəʑəs
achzeg	ɑχtsəɕ
acompte	ɑkɑ̃ːnt
acomptë	ɑkɑ̃ːntə
acompten	ɑkɑ̃ːntən
acompter	ɑkɑ̃ːntɐ
acquis	ɑkiː
acquise	ɑkiːə
acquisen	ɑkiːən
acquisitioun	ɑkizitsjəʊn
acquittéiere	ɑkitɜɪəʀə
acteur	ɑktœːʀ
acteure	ɑktœːʀə
actionnairinne	ɑksjoːnɛːʀinə
äddi	ædiː
äddie	ædiːə
äddien	ædiːən
adeleg	aːdələɕ
adelege	aːdələʑə
adequaatst	ɑdekwaːtst
adequaatste	ɑdekwaːtstə
adhésioun	ɑtheːzjəʊn
adjektiv	ɑtjektiːf
adjoint	ɑdʒwɛ̃ː
adjointë	ɑdʒwɛ̃ːə
adjointe	ɑdʒwɛ̃ːnt
adjointeë	ɑdʒwɛ̃ːntə
adjointeën	ɑdʒwɛ̃ːntən
adjointen	ɑdʒwɛ̃ːən
adjutant	ɑdʒutɑnt
adjutante	ɑdʒutɑntə
adjutanten	ɑdʒutɑntən
adjutantin	ɑdʒutɑntin
adjutantinne	ɑdʒutɑntinə
adjutantinnen	ɑdʒutɑntinən
adler	aːdlɐ
admirolinne	aːtmiʀoːlinə
adolphe	ɑdolf
adoptéiere	ɑdoptɜɪəʀə
adoptéieren	ɑdoptɜɪəʀən
adoptiounsfamill	ɑdoptjəʊnsfɑmil
adoptiounsfamille	ɑdoptjəʊnsfɑmilə
adoptivjongen	ɑdoptiːfjoŋən
adoptivkand	ɑdoptiːfkɑnt
adoptivmamme	ɑdoptiːfmɑmə
adress	ɑdʀæs
adressate	ɑdʀæsɑt
adresséiere	ɑdʀæsɜɪəʀə
adresséieren	ɑdʀæsɜɪəʀən
adriatesches	ɑdʀjaːtəʃəs
adventskalenner	ɑdvæntskɑlænɐ
ae	aːə
aen	aːən
aendeckel	aːəndækəl
aendokter	aːəndoktɐ
äerd	ɛːɐt
äerdbier	ɛːɐtbiːɐ
äerdbiewe	ɛːɐtbiəvə
äerdbiewen	ɛːɐtbiəvən
äerdeg	ɛːɐdəɕ
äerdejoer	ɛːɐdəjoːɐ
aerobic	ɛːʀobik
aerodynamesch	ɛːʀoːdinaːməʃ
aerodynamik	aːəʀoːdinɑmik
äert	ɛːɐt
af	aːf
afaalt	ɑfaːlt
afalen	ɑfaːlən
afe	aːfə
afeger	aːfəʑɐ
afegst	aːfəɕst
afegste	aːfəɕstə
afëllen	ɑfələn
afen	aːfən
affär	ɑfɛːʀ
affekot	ɑfəkoːt
affekotecabinet	ɑfəkoːtəkɑbineː
affekotinne	ɑfəkoːtinə
affer	ɑfɐ
affere	ɑfəʀə
afferen	ɑfəʀən
afferstack	ɑfɐʃtɑk
affichagë	ɑfiʃaːʒə
affinitéit	ɑfinitɜɪt
affirmativem	ɑfiʀmɑtiːvəm
affisch	ɑfiʃ
affischéiere	ɑfiʃɜɪəʀə
affischéieren	ɑfiʃɜɪəʀən
afganistan	ɑfgaːnistaːn
afoul	ɑfəʊl
afoulen	ɑfəʊlən
afouls	ɑfəʊls
afoult	ɑfəʊlt
afüge	ɑfyːʑə
afügen	ɑfyːʑən
agank	ɑgɑŋk
agebaute	ɑgəbæːʊt
agebilt	ɑgəbilt
agebilte	ɑgəbiltə
agebilten	ɑgəbiltən
agebuerene	ɑgəbuəʀənə
agebuerenen	ɑgəbuəʀənən
agecheckt	ɑgetʃækt
agecheckte	ɑgetʃæktə
agechecktem	ɑgetʃæktəm
agence	ɑʒɑ̃ːs
agenda	ɑʒændaː
agentinne	ɑgæntinə
agestoe	ɑgəʃtoːə
agestoen	ɑgəʃtoːən
agglomeratioun	ɑglomeʀatsjəʊn
agoe	ɑgoːə
agoen	ɑgoːən
agréabel	ɑgʀeaːbəl
agreabele	ɑgʀeaːbələ
agreabelem	ɑgʀeaːbələm
ähnlech	ɛːnləɕ
ahor	aːoːʀ
ahorn	aːhɔʀn
ahorne	aːhɔʀnə
aide	ɛːt
aiden	ɛːdən
aids	ɜɪts
äis	æːɪs
äisbier	æːɪsbiːɐ
äiseg	æːɪzəɕ
äisege	æːɪzəʑə
äisegem	æːɪzəʑəm
äisegen	æːɪzəʑən
äiser	æːɪzɐ
äiskal	æːɪskaːl
äiskonschtleeferinne	æːɪskonʃtleːfəʀinə
äisschongfuere	æːɪsʃoŋfuəʀə
äisschongfueren	æːɪsʃoŋfuəʀən
ajustéiere	ɑʒystɜɪəʀə
ajustéieren	ɑʒystɜɪəʀən
akachs	ɑkɑχs
akacht	ɑkɑχt
akademikerinne	ɑkaːdeːmikəʀinə
akaf	ɑkaːf
akafe	ɑkaːfə
akafen	ɑkaːfən
akafskuerf	ɑkaːfskuəf
akafsweenche	ɑkaːfsveːnɕə
akafsweenchen	ɑkaːfsveːnɕən
akaul	aːkɑʊl
akeren	aːkəʀən
akkord	ɑkɔːʀ
akkord	ɑkɔχt
akkorden	ɑkɔːʀən
akkorden	ɑkɔʀdən
akkordeon	ɑkɔʀdeːɑ̃ː
akkordeone	ɑkɔʀdeːɑ̃ːə
akkordeonen	ɑkɔʀdeːɑ̃ːən
akkordeonist	ɑkɔːʀdeːonist
akku	ɑkuː
akkue	ɑkuːə
akkuen	ɑkuːən
aklamme	ɑklɑmə
aklammen	ɑklɑmən
aklemme	ɑklæmə
aklemmen	ɑklæmən
akrobat	ɑkʀobaːt
akrobate	ɑkʀobaːtə
akrobaten	ɑkʀobaːtən
akrobatinne	ɑkʀobaːtinə
akt	ɑkt
aktie	ɑksjə
aktien	ɑksjən
aktionärinne	ɑksjoːnɛːʀinə
aktioun	ɑksjəʊn
aktiv	ɑktiːf
aktiven	ɑktiːvən
aktiver	ɑktiːvɐ
aktivistinne	ɑktivistinə
aktivitéit	ɑktivitɜɪt
aktuell	ɑktwæl
al	aːl
aläert	ɑlɛːɐt
alain	ɑlɛ̃ː
alarm	ɑlaːʀm
albanien	ɑlbɑnjən
album	ɑlbum
ale	aːlə
alen	aːlən
alertéiere	ɑlæʀtɜɪəʀə
alertéieren	ɑlæʀtɜɪəʀən
alg	ɑlɕ
alge	ɑlʑə
algen	ɑlʑən
algeresch	ɑlʒeːʀəʃ
algerier	ɑlʒeːʀiːɐ
alibien	aːlibiːən
aliichte	ɑliːɕtə
aliichten	ɑliːɕtən
alkohol	ɑlkohoːl
alkohole	ɑlkohoːlə
alkoholikerinne	ɑlkohoːlikəʀinə
all	ɑl
allebéid	ɑləbɜɪt
alleguer	ɑləguːɐ
allergië	ɑlæʀʒiːə
allergien	ɑlæʀʒiːən
allerhellge	ɑlɐhælʑə
allerhellgen	ɑlɐhælʑən
allerlee	ɑlɐleː
allerséile	ɑlɐzɜɪlə
allerséilen	ɑlɐzɜɪlən
alles	ɑləs
allgemeng	ɑlgəmæŋ
allianz	ɑljɑnts
allianze	ɑljɑntsə
allianzen	ɑljɑntsən
alliéierten	ɑljɜɪɐtən
alliéierter	ɑljɜɪɐtɐ
allo	ɑloː
allür	ɑlyːʀ
allüre	ɑlyːʀ
allure	ɑlyːʀə
allurë	ɑlyːʀə
alluren	ɑlyːʀən
almose	ɑlmoːzə
almosen	ɑlmoːzən
almoudesch	aːlməʊdəʃ
alpinistinne	ɑlpinistinə
alrodeschhaff	aːlʀoːdəʃhɑf
als	ɑls
also	ɑlzoː
alstad	aːlʃtaːt
alter	ɑltɐ
alternativ	ɑltɛɐnatiːf
altersgrenz	ɑltɐsgʀænts
altertum	ɑltɐtum
altess	ɑltæs
altesse	ɑltæs
altesse	ɑltæsə
altessen	ɑltæsən
aluede	ɑluədə
alueden	ɑluədən
aluminium	ɑluminjum
alzeng	ɑltseŋ
am	ɑm
amaache	ɑmaːχə
amaachen	ɑmaːχən
amaachglas	ɑmaːχglaːs
amant	ɑmɑ̃ː
amante	ɑmɑ̃ːə
amanten	ɑmɑ̃ːən
amass	ɑmɑs
amateur	ɑmɑtœːʀ
ambassad	ɑmbɑsaːt
ambassadë	ɑ̃ːmbɑsaːdə
ambassade	ɑ̃ːmbɑsaːt
ambassaden	ɑ̃ːmbɑsaːdən
ambassadeur	ɑ̃ːmbɑsɑdœːʀ
ambigu	ɑ̃ːmbigyː
ambigue	ɑ̃ːmbigyːə
ambiguem	ɑ̃ːmbigyːəm
ambiguen	ɑ̃ːmbigyːən
ambiguitéit	ɑ̃ːmbigyːitɜɪt
ambiguitéite	ɑ̃ːmbigyːitɜɪt
ambiguitéiten	ɑ̃ːmbigyitɜɪtən
ambitiéis	ɑ̃ːmbisjɜɪs
ambitiéise	ɑ̃ːmbisjɜɪzə
amboss	ɑmbos
ambulanz	ɑmbulɑnts
améchs	ɑməɕs
amelioratioun	ɑmeljoʀatsjəʊn
amen	aːmən
amenagéiere	ɑmenaʒɜɪəʀə
amenagéieren	ɑmenaʒɜɪəʀən
amendéier	ɑmɑ̃ːndɜɪɐ
amendéieren	ɑmɑ̃ːndɜɪəʀən
amendement	ɑmɑ̃ːndəmɑ̃ː
ament	ɑmænt
amerika	ɑmeːʀikaː
amësche	ɑməʃə
amëschen	ɑməʃən
ameséiere	ɑməzɜɪəʀə
ameséieren	ɑməzɜɪəʀən
amgaang	ɑmgaːŋ
amicalle	ɑmikɑlə
amicallen	ɑmikɑlən
aminosaier	ɑmiːnoːzɑɪɐ
amnesie	ɑmnesiː
amnestie	ɑmnæstiː
amnestië	ɑmnæstiːə
amok	aːmok
amokleeferinne	ɑmokleːfəʀinə
amortiséiere	ɑmɔʀtizɜɪəʀə
amortiséieren	ɑmɔʀtizɜɪəʀən
amortisseur	ɑmɔʀtisœːʀ
ampère	ɑ̃ːpɛːʀ
amplaz	ɑmplaːts
ampull	ɑmpul
amusant	ɑmuzɑnt
amusantem	ɑmuzɑntəm
amüsantem	ɑmysɑntəm
amüsantst	ɑmysɑntst
amusantste	ɑmuzɑntstə
amusement	ɑmuzəmænt
an	aːn
an	ɑn
anachronismen	ɑnɑkʀonismən
anachronismus	ɑnɑkʀonismus
analoger	ɑnaloːʁɐ
analogie	ɑnaloʒiː
analogië	ɑnaloʒiːə
analogien	ɑnaloʒiːən
analoogt	ɑnaloːχt
analphabet	ɑnalfabeːt
analphabete	ɑnalfabeːtə
analphabeten	ɑnalfabeːtən
analphabetin	ɑnalfabeːtin
analphabetinne	ɑnalfabeːtinə
analyse	ɑnaliːzə
analytikerinne	ɑnalitikəʀinə
ananas	ɑnanaːs
anarchie	ɑnaʀɕiə
anarchistinne	ɑnaʀɕistinə
anäscheren	ɑnæʃəʀən
anästhesie	ɑnæsteziː
anästhesië	ɑnæsteziːə
anästhesistinne	ɑnæstesistinə
anatomie	ɑnatomiː
anchecken	ɑntʃækən
anchoisen	ɑ̃ːʃwɑən
anciennetéit	ɑ̃ːsjænətɜɪt
andorra	ɑndoʀaː
anekdot	ɑnækdoːt
anemie	ɑnemiː
aneneen	ɑnəneːn
aner	aːnɐ
anere	aːnəʀə
aneren	aːnəʀən
anescht	aːnəʃt
angab	ɑngaːp
angabe	ɑngaːbə
angenehm	ɑngəneːm
angine	ɑ̃ːʒin
anginne	ɑ̃ːʒinə
angola	ɑngoːlaː
angscht	ɑŋʃt
ängschtlech	æŋʃtləɕ
animateur	ɑnimatœːʀ
animéiere	ɑnimɜɪəʀə
animéieren	ɑnimɜɪəʀən
animositéit	ɑnimozitɜɪt
anker	ɑŋkɐ
annäipen	ɑnnæːɪpən
ännere	ænəʀə
änneren	ænəʀən
ännerung	ænəʀuŋ
anniichter	ɑniːɕtɐ
anniversaire	ɑnivæʀsɛːʀ
anniversairë	ɑnivæʀsɛːʀə
anniversairen	ɑnivæʀsɛːʀən
anno	ɑnoː
annonce	ɑnɑ̃ːs
annoncéiere	ɑnɑ̃ːsɜɪəʀə
annoncéieren	ɑnɑ̃ːsɜɪəʀən
annuléiere	ɑnylɜɪəʀə
annuléieren	ɑnylɜɪəʀən
anomalie	ɑnomaliː
anomalië	ɑnomaliːə
anonym	ɑnonim
anonymmen	ɑnonimən
anorak	ɑnoʀɑk
anormal	ɑnɔʀmaːl
anotems	ɑnoːtəms
anotemt	ɑnoːtəmt
antenn	ɑntæn
antenne	ɑ̃ːntæn
antennen	ɑ̃ːntænən
antëscht	ɑntəʃt
antibiotique	ɑntibjotik
antibiotiquë	ɑntibjotikə
antibiotiquen	ɑntibjotikən
anticke	ɑntikə
antickem	ɑntikəm
antigel	ɑ̃ːtiʒæl
antiguaner	ɑntigwaːnɐ
antik	ɑntik
antikst	ɑntikst
antippe	ɑntipə
antippen	ɑntipən
antiquaire	ɑ̃ːtikɛːʀ
antiquitéit	ɑ̃ːntikitɜɪt
antisemitesch	ɑntizemitəʃ
antisemitinne	ɑntizemitinə
antivol	ɑ̃ːntivol
antoniushaff	ɑntoːnjushɑf
antriichtere	ɑntʀiːɕtəʀə
antriichteren	ɑntʀiːɕtəʀən
äntwere	æntvəʀə
äntweren	æntvəʀən
äntwert	æntvɐt
anzeblende	ɑntsəblændə
anzeblenden	ɑntsəblændən
anzeblenne	ɑntsəblænə
anzeblennen	ɑntsəblænən
anzebrénge	ɑntsəbʀeŋə
anzebréngen	ɑntsəbʀeŋən
anzebrenne	ɑntsəbʀænə
anzesange	ɑntsəzɑŋə
anzwousch	ɑntswəʊʃ
anzwuersch	ɑntswuːɐʃ
apaart	ɑpaːʀt
apake	ɑpaːkə
apaken	ɑpaːkən
apdikt	ɑpdikt
apdikter	ɑpdiktɐ
apel	aːpəl
apendelen	ɑpəndələn
aperhoer	aːpɐhoːɐ
aperitif	ɑpeʀitif
apostel	ɑpostəl
apostele	ɑpostələ
apostolesch	ɑpostoːləʃ
apostroph	ɑpostʀof
apparat	ɑpɑʀaːt
appartement	ɑpɑʀtəmænt
äppelbam	æpəlbaːm
äppeljus	æpəlʒyː
appellsprozess	ɑpælspʀotsæs
appetit	ɑpətit
appetitlech	ɑpətitləɕ
applaus	ɑplɑʊs
apple	æpəl
appreciatioun	ɑpʀesjatsjəʊn
approche	ɑpʀoʃ
approchë	ɑpʀoʃə
approchen	ɑpʀoʃən
approuvéiere	ɑpʀuvɜɪəʀə
approuvéieren	ɑpʀuvɜɪəʀən
approximatiivt	ɑpʀoksimɑtiːft
approximativ	ɑpʀoksimɑtiːf
approximative	ɑpʀoksimaːtiːvə
appui	ɑpɥiː
apräägs	ɑpʀɛːɕs
aprägen	ɑpʀɛːʑən
aprikos	ɑpʀikoːs
aquakulture	ɑkwaːkultuːʀ
aquaplaning	ɑkwaːplaːniŋ
aquarium	ɑkwaːʀium
äquator	eːkwaːtoːʀ
är	ɛːɐ
araberin	ɑʀabəʀin
arabesch	ɑʀaːbəʃ
arabist	ɑʀabist
arabophonen	ɑʀabofoːnən
araume	ɑʀɑʊmə
araumen	ɑʀɑʊmən
arbitter	ɑʀbitɐ
arbitterinne	ɑʀbitəʀinə
arcadë	ɑʀkaːdə
arcade	ɑʀkaːt
arcaden	ɑʀkaːdən
archaesch	ɑʀkaːəʃ
archaeschen	ɑʀkaːəʃən
archeolog	ɑʀkeoloːk
archeologe	ɑʀkeoloːgə
archeologen	ɑʀkeoloːgən
archeologinne	ɑʀkeoloːginə
architekt	ɑʀʃitækt
architektinne	ɑʀɕitæktinə
architektur	ɑʀɕitæktuːɐ
architekture	ɑʀɕitæktuːʀə
architekturen	ɑʀɕitæktuːʀən
archiv	ɑʀɕiːf
archive	ɑʀɕivə
archivistinne	ɑʀɕivistinə
äre	ɛːʀə
arem	aːʀəm
ären	ɛːʀən
arenne	ɑʀænə
arennen	ɑʀænən
ärer	ɛːʀɐ
argentinesch	ɑʀʑæntiːnəʃ
ariichte	ɑʀiːɕtə
ariichten	ɑʀiːɕtən
aristokratie	ɑʀistokʀatiː
aristokratinne	ɑʀistokʀaːtinə
arméi	ɑʀmɜɪ
armenesch	ɑʀmeːnəʃ
aroma	ɑʀoːmaː
aromatesch	ɑʀomaːtəʃ
arrêt	ɑʀɛː
arrête	ɑʀɛːə
arrêté	ɑʀɛːteː
arrêtéë	ɑʀɛːteːə
arrêtéen	ɑʀɛːteːən
arrêten	ɑʀɛːən
arrivée	ɑʀiveː
arrogant	ɑʀogɑnt
arrogante	ɑʀogɑntə
arterie	ɑʀteːʀjə
arterien	ɑʀteːʀjən
arthrite	ɑʀtʀit
artichaut	ɑʀtiʃoː
artikel	ɑʀtikəl
artist	ɑʀtist
artisteschste	ɑʀtistəʃstə
artisteschstem	ɑʀtistəʃstəm
artisteschsten	ɑʀtistəʃstən
artisteschster	ɑʀtistəʃstɐ
artistinne	ɑʀtistinə
asammele	ɑzɑmələ
asammelen	ɑzɑmələn
asazfäegster	ɑzaːtsfɛːəɕstɐ
asazfäegt	ɑzaːtsfɛːəɕt
asazfäheg	ɑzaːtsfɛːəɕ
äsche	æʃə
äschebecher	æʃəbæɕɐ
äschen	æʃən
äschenteller	æʃəntælɐ
äschermëttwoch	æʃɐmətwoχ
aschloe	ɑʃloːə
aschloen	ɑʃloːən
aschlofe	ɑʃloːfə
aschlofen	ɑʃloːfən
aserbaidjan	ɑzɛːɐbɑɪdʒaːn
aspaans	ɑʃpaːns
aspaant	ɑʃpaːnt
aspäre	ɑʃpɛːʀə
aspären	ɑʃpɛːʀən
aspekt	ɑspækt
aspro	ɑspʀoː
assimiléieren	ɑsimilɜɪəʀən
assistant	ɑsistɑ̃ː
assistentinne	ɑsistæntinə
associatioun	ɑsosjatsjəʊn
associé	ɑsosieː
associée	ɑsosjeː
associéë	ɑsosjeːə
associéeë	ɑsosjeːə
associéeën	ɑsosjeːən
assurance	ɑsyʀɑ̃ːs
assuréiere	ɑsyʀɜɪəʀə
assuréieren	ɑsyʀɜɪəʀən
astéings	ɑʃtɜɪŋs
astéingt	ɑʃtɜɪŋt
astelle	ɑʃtælə
astellen	ɑʃtælən
ästhet	æsteːt
asthma	ɑstmaː
asti	ɑstiː
astig	ɑʃtiːɕ
astigsdrog	ɑstiːɕsdʀoːk
astouch	ɑʃtəʊχ
astoungen	ɑʃtəʊŋən
astoungs	ɑʃtəʊŋs
astrolog	ɑstʀoloːχ
astrologe	ɑstʀoloːʁə
astrologen	ɑstʀoloːʁən
astrologinne	ɑstʀoloːginə
astronaut	ɑstʀonɑʊt
astronautinne	ɑstʀonɑʊtinə
astronom	ɑstʀonoːm
asturien	ɑstuːʀiən
asylantinne	ɑsilɑntinə
asymmetresch	ɑsimeːtʀəʃ
asymmetrie	ɑsimetʀiː
atelier	ɑtəljeː
ateliere	ɑtəljeːə
atert	aːtɐt
atheismus	ɑteismus
atheistinne	ɑteːistinə
athen	ɑteːn
äthiopien	ætjopiːən
athlet	ɑtleːt
athletinne	ɑtleːtinə
atlas	ɑtlɑs
atom	ɑtoːm
atomreakter	ɑtoːmʀeɑktɐ
atoute	ɑtuːə
atouten	ɑtuːən
attache	ɑtɑʃ
attentat	ɑtəntaːt
attentater	ɑtəntaːtɐ
attentäter	ɑtəntɛːtɐ
attentäterinne	ɑtɑ̃ːtɛːtəʀinə
atter	ɑtɐ
attest	ɑtæst
attestatioun	ɑtæstatsjəʊn
attitude	ɑtityːt
attitudë	ɑtitydə
attraktioun	ɑtʀɑksjəʊn
aubergine	oːbɛʀʒin
auberginne	oːbɛʀʒinə
auchan	oːʃɑ̃ː
auder	ɑʊdɐ
audi	ɑʊdiː
audienz	ɑʊdjænts
audienze	ɑʊdjæntsə
audiovisuell	ɑʊdjoːviːzwæl
audiovisuell	ɑʊdjoːvizwæl
auditoire	oːditwaːʀ
auditoirë	oːditwaːʀə
auer	ɑʊɐ
auermécher	ɑʊɐməɕɐ
aufgab	ɑʊfgaːp
aufsatz	ɑʊfsɑts
august	ɑʊgust
aumônier	oːmonjeː
aura	ɑʊʀaː
aus	æːʊs
ausbau	æːʊsbæːʊ
ausbaue	æːʊsbɑʊə
ausbauen	æːʊsbɑʊən
ausbehale	æːʊsbəhaːlə
ausbehalen	æːʊsbəhaːlən
ausdeele	æːʊsdeːlə
ausdeelen	æːʊsdeːlən
ausdoe	æːʊsdoːə
ausdoen	æːʊsdoːən
ausdrécke	æːʊsdʀekə
ausdrécken	æːʊsdʀekən
ausdrock	æːʊsdʀok
ausdrocksvoll	æːʊsdʀoksfol
auserhéngert	æːʊzɐheŋɐt
ausernee	æːʊzɐneː
auserneen	æːʊzɐneːn
ausféiere	æːʊsfɜɪəʀə
ausféieren	æːʊsfɜɪəʀən
ausfëlle	æːʊsfələ
ausfëllen	æːʊsfələn
ausflug	æːʊsfluχ
ausgab	æːʊsgaːp
ausgebeut	æːʊsgəboɪt
ausgebeute	æːʊsgəboɪtə
ausgerechent	æːʊsgəʀæɕənt
ausgesinn	æːʊsgəzin
ausginn	æːʊsgin
ausgoe	æːʊsgoːə
ausgoen	æːʊsgoːən
aushéngere	æːʊsheŋəʀə
aushéngeren	æːʊsheŋəʀən
aushoul	æːʊshəʊl
aushoulen	æːʊshəʊlən
aushouls	æːʊshəʊls
aushoult	æːʊshəʊlt
aushoung	æːʊshəʊŋ
aushoungen	æːʊshəʊŋən
auskräischs	æːʊskʀæːɪʃs
auslafe	æːʊslaːfə
auslafen	æːʊslaːfən
ausland	æːʊslɑnt
auslänner	æːʊslænɐ
auslännerinne	æːʊslænəʀinə
auslännesch	æːʊslænəʃ
auslous	æːʊsləʊs
auslouse	æːʊsləʊs
auslousen	æːʊsləʊzən
ausloust	æːʊsləʊst
ausluede	æːʊsluədə
auslueden	æːʊsluədən
ausmaache	æːʊsmaːχə
ausmaachen	æːʊsmaːχən
ausnahm	æːʊsnaːm
ausnotze	æːʊsnotsə
ausnotzen	æːʊsnotsən
auspäife	æːʊspæːɪfə
auspäifen	æːʊspæːɪfən
auspéile	æːʊspɜɪlə
auspéilen	æːʊspɜɪlən
auspuff	æːʊspuf
ausraibere	æːʊsʀɑɪbəʀə
ausraiberen	æːʊsʀɑɪbəʀən
ausraume	æːʊsʀɑʊmə
ausraumen	æːʊsʀɑʊmən
ausrechne	æːʊsʀæɕnə
ausrechnen	æːʊsʀæɕnən
ausrësele	æːʊsʀəzələ
ausrëselen	æːʊsʀəzələn
ausrësserinne	æːʊsʀəsəʀinə
ausriede	æːʊsʀiədə
ausrieden	æːʊsʀiədən
ausrifferinne	æːʊsʀifəʀinə
ausroue	æːʊsʀəʊə
ausrouen	æːʊsʀəʊən
ausrutsche	æːʊsʀutʃə
ausrutschen	æːʊsʀutʃən
ausschëdde	æːʊsʃədə
ausschëdden	æːʊsʃədən
ausschlaggebend	æːʊsʃlaːχgeːbənt
ausschlaggebende	æːʊsʃlaːχgeːbəndə
ausschlaggebendem	æːʊsʃlaːχgeːbəndəm
ausschlaggebenden	æːʊsʃlaːχgeːbəndən
ausschlofe	æːʊsʃloːfe
ausschlofen	æːʊsʃloːfen
ausschnëtt	æːʊsʃnət
ausseministerinne	æːʊsəministəʀinə
ausser	æːʊsɐ
aussergewéinlech	æːʊsɐgəvɜɪnləɕ
äusserlech	oɪsɐləɕ
ausseruerdentlech	æːʊsɐuːɐdəntləɕ
ausseruerdentleche	æːʊsɐuːɐdəntləɕə
ausseruerdentlechem	æːʊsɐuːɐdəntləɕəm
ausseruerdentlechen	æːʊsɐuːɐdəntləɕən
ausseruerdentlecher	æːʊsɐuːɐdəntləɕɐ
ausseruerdentlechst	æːʊsɐuːɐdəntləɕst
äusserung	oɪsəʀuŋ
aussesäiterinne	æːʊszəzæːɪtəʀinə
ausso	æːʊszoː
ausspane	æːʊsʃpaːnə
ausspanen	æːʊsʃpaːnən
aussprieche	æːʊsʃpʀiəɕə
ausspriechen	æːʊsʃpʀiəɕən
aussprooch	æːʊsʃpʀoːχ
ausstelle	æːʊsʃtælə
ausstellen	æːʊsʃtælən
ausstellerinne	æːʊsʃtæləʀinə
ausstellung	æːʊsʃtæluŋ
ausstierwe	æːʊsʃtiəvə
ausstierwen	æːʊsʃtiəvən
australier	æːʊstʀɑljɐ
australierin	æːʊstʀɑliəʀin
auswäiche	æːʊsvæːɪɕə
auswäichen	æːʊsvæːɪɕən
auswanderinne	æːʊsvɑndəʀinə
auswenneg	æːʊsvænəɕ
auswësche	æːʊsvəʃə
auswëschen	æːʊsvəʃən
auswiel	æːʊsviəl
auszedoe	æːʊstsədoːə
auszepake	æːʊstsəpaːkə
autant	oːtɑ̃ː
auteur	oːtœːʀ
authentesch	ɑʊtəntəʃ
autistesch	ɑʊtistəʃ
auto	ɑʊtoː
autobiografie	ɑʊtoːbiogʀafiː
autobiographie	ɑʊtoːbiogʀafiː
autobunn	ɑʊtoːbun
autobunnssortie	ɑʊtoːbunsɔʀtiː
autocollant	oːtoːkolɑ̃ː
autofuerer	ɑʊtoːfuəʀɐ
automobilistinne	ɑʊtoːmobilistinə
autonomie	ɑʊtoːnomiː
autorinne	ɑʊtoːʀinə
autoscoureur	ɑʊtoːskuːʀœːʀ
autoscourse	ɑʊtoːskuʀs
auxerrois	oːksæʀwɑ
avancen	ɑvɑ̃ːsən
avantage	ɑvɑ̃ːtaːʃ
avenue	ɑvənyː
avenuen	ɑvənyːən
averstan	ɑfɐʃtaːn
avertéieren	ɑvæʀtɜɪəʀən
avertéiers	ɑvæʀtɜɪɐs
avion	ɑviɑ̃ː
avis	ɑviː
avise	ɑviːə
avisen	ɑviːən
avortéieren	ɑvɔʀtɜɪəʀən
awanderinne	ɑvɑndəʀinə
awar	ɑvaːʀ
aweeche	ɑveːɕə
aweechen	ɑveːɕən
aweie	ɑvɑɪə
aweien	ɑvɑɪən
awëllege	ɑvələʑə
awëllegen	ɑvələʑən
awëllegung	ɑvələʑuŋ
awer	aːvɐ
awerglaf	aːvɐglaːf
awuer	ɑvuːɐ
awunner	ɑvunɐ
awunnerinne	ɑvunəʀinə
baach	baːχ
baang	baːŋ
baarbes	baːʀbəs
baarf	baːɐf
baarmhäerzegkeet	baːɐmhɛːɐtsəɕkeːt
baart	baːʀt
baartbiischt	baːʀtbiːʃt
baasch	baːʃ
babbele	bɑbələ
babbelen	bɑbələn
babysitterinne	bɑbiːsitəʀinə
bäcker	bækɐ
bäckerei	bækəʀɑɪ
bäckesch	bækəʃ
bad	baːt
badgë	bædʒə
badge	bætʃ
badgen	bædʒən
badminton	bætmintən
bäerdref	bɛːɐdʀəf
baffe	bɑfə
baffen	bɑfən
bagage	bɑgaːʃ
bagatell	bɑgatæl
bagger	bɑgɐ
bahamas	bɑhaːmas
bäichelche	bæːɪɕəlɕə
bäichelchen	bæːɪɕəlɕən
baichelcher	bɑɪɕəlɕɐ
bäiginn	bæːɪgin
bäigoe	bæːɪgoːə
bäigoen	bæːɪgoːən
bäilafe	bæːɪlaːfə
bäilafen	bæːɪlaːfən
bäilagen	bæːɪlaːʁən
bäileed	bæːɪleːt
bailen	bɑɪjən
bäiluegt	bæːɪluəɕt
bäisse	bæːɪsə
baisse	bæs
bäissen	bæːɪsən
bäiwunne	bæːɪvunə
bäiwunnen	bæːɪvunən
bak	baːk
bake	baːkə
baken	baːkən
bakzant	baːktsɑnt
bal	baːl
balkankrich	bɑlkaːnkʀiɕ
balkon	bɑlkɑ̃ː
ball	bɑl
ballet	bɑleː
ballon	bɑlɑ̃ː
ballotage	bɑlotaːʃ
balucke	bɑlukə
balucken	bɑlukən
bam	baːm
bampele	bɑmpələ
bampelen	bɑmpələn
bamstamm	baːmʃtɑm
banal	bɑnaːl
banane	bɑnɑn
band	bɑnt
bandage	bɑndaːʃ
banditinne	bɑnditinə
bänk	bæŋk
bank	bɑŋk
bänke	bæŋkə
banke	bɑŋkə
bänken	bæŋkən
banken	bɑŋkən
bankerinne	bæŋkəʀinə
banne	bɑnə
bannen	bɑnən
bannendes	bɑnəndəs
bannenhaff	bɑnənhɑf
bänner	bænɐ
bare	baːʀə
baroninne	bɑʀoːninə
barpianist	baːʀpjɑnist
barrage	bɑʀaːʃ
barrière	bɑʀiɛːʀ
bascht	bɑʃt
baschte	bɑʃtə
baschten	bɑʃtən
basis	baːzis
basketspillerinne	bɑskætʃpiləʀinə
baskett	bɑskæt
bass	bɑs
bassistinne	bɑsistinə
bastele	bɑstələ
bastelen	bɑstələn
bastlerinne	bɑstləʀinə
bataklang	bɑtɑklɑŋ
batter	bɑtɐ
batterie	bɑtəʀiː
bätz	bæts
batz	bɑts
bau	bæːʊ
bauaarbechterinne	bæːʊaːɐbəɕtəʀinə
bauch	bæːʊχ
baue	bɑʊə
bauen	bɑʊən
bauer	bɑʊɐ
bauerenhaff	bɑʊəʀənhɑf
baufälleg	bæːʊfæləɕ
baukaste	bɑʊkɑstə
baukasten	bɑʊkɑstən
baupse	bɑʊpsə
baupsen	bɑʊpsən
bauscheg	bæːʊʃəɕ
bausse	bæːʊsə
baussen	bæːʊsən
bd	beːdeː
beaaften	bəaːftən
beaarbecht	bəaːɐbəɕt
beaarbechte	bəaːɐbəɕtə
beafe	bəaːfə
beafloss	bəɑflos
beamte	bəɑmtə
beamtebeleidegung	bəɑmtəbəlɑɪdəʑuŋ
beamten	bəɑmtən
beandrock	bəɑndʀok
beandrocke	bəɑndʀokə
beängschtegend	bəæŋʃtəʑənt
beäntwer	bəæntvɐ
beäntwere	bəæntvəʀə
beauté	boːteː
becher	bæɕɐ
béchs	beks
béchse	beksə
béchsefleesch	beksəfleːʃ
béchsen	beksən
béchsenöffner	beksənœfnɐ
bécke	bekə
bécken	bekən
bedauere	bədɑʊəʀə
bedaueren	bədɑʊəʀən
bedauerlech	bədɑʊɐləɕ
bedeite	bədɑɪtə
bedeiten	bədɑɪtən
bedeitend	bədɑɪtənt
bedierfnesser	bədiːɐfnəsɐ
bedrécke	bədʀekə
bedrécken	bədʀekən
bedreckse	bədʀæksə
bedrecksen	bədʀæksən
bedupse	bədupsə
bedupsen	bədupsən
bee	beː
beeme	beːmə
beemen	beːmən
been	beːn
bees	beːs
beesen	beːsən
befriddegend	bəfʀidəʑənt
begaabt	bəgaːpt
begeeschtert	bəgeːʃtɐt
begeeschterung	bəgeːʃtəʀuŋ
begéine	bəgɜɪnə
begéinen	bəgɜɪnən
begleede	bəgleːdə
begleeden	bəgleːdən
begradegen	bəgʀaːdəʑən
begräife	bəgʀæːɪfə
begräifen	bəgʀæːɪfən
begréisse	bəgʀɜɪsə
begréissen	bəgʀɜɪsən
begréissung	bəgʀɜɪsuŋ
begriefnes	bəgʀiəfnəs
begruewe	bəgʀuəvə
begruewen	bəgʀuəvən
behaapte	bəhaːptə
behaapten	bəhaːptən
behandele	bəhɑndələ
behandelen	bəhɑndələn
behenn	bəhæn
behuele	bəhuələ
behuelen	bəhuələn
bei	bɑɪ
béie	bɜɪə
beiekinniginne	bɑɪəkiniginə
béien	bɜɪən
beienee	bɑɪəneː
beieneen	bɑɪəneːn
beienziichterinne	bɑɪəntsiːɕtəʀinə
béier	bɜɪɐ
beiestack	bɑɪəʃtɑk
beifall	bɑɪfɑl
beige	bɛːʃ
beil	bɑɪl
beim	bɑɪm
béis	bɜɪs
beispill	bɑɪʃpil
bejoe	bəjoːə
bejoen	bəjoːən
bekannt	bəkɑnt
bekannte	bəkɑntə
bekannten	bəkɑntən
bekanntschaft	bəkɑntʃɑft
bekäppe	bəkæpə
bekäppen	bəkæpən
bekéierunge	bəkɜɪəʀuŋə
bekloe	bəkloːə
bekloen	bəkloːən
bekucke	bəkukə
bekucken	bəkukən
belagere	bəlaːgəʀə
belageren	bəlaːgəʀən
belästege	bəlæstəʑə
belästegen	bəlæstəʑən
beléie	bəlɜɪə
beléien	bəlɜɪən
belibeg	bəliːbəɕ
beliichte	bəliːɕtə
beliichten	bəliːɕtən
beliichtung	bəliːɕtuŋ
bëlleg	bələɕ
beloune	bələʊnə
belounen	bələʊnən
belounung	bələʊnuŋ
belsch	bælʃ
bemustere	bəmustəʀə
bemusteren	bəmustəʀən
bëndelche	bəndəlɕə
bëndelchen	bəndəlɕən
beneiden	bənɑɪdən
benevol	benevol
bengel	bæŋəl
beniwwelen	bənivələn
benotze	bənotsə
benotzen	bənotsən
benotzerinne	bənotsəʀinə
benotzerrotschlag	bənotsɐʀoːtʃlaːχ
bensin	bænzin
bensinspompel	bænzinspompəl
bensinsstatioun	bænzinsʃtatsjəʊn
berappe	bəʀɑpə
berappen	bəʀɑpən
berechne	bəʀæɕnə
berechnen	bəʀæɕnən
berechnung	bəʀæɕnuŋ
beréiere	bəʀɜɪəʀə
beréieren	bəʀɜɪəʀən
berode	bəʀoːdə
beroden	bəʀoːdən
beroderinne	bəʀoːdəʀinə
berouege	bəʀəʊəʑə
berouegen	bəʀəʊəʑən
berouegungsmëttel	bəʀəʊəʑuŋsmətəl
berri	bæʀiː
beruff	bəʀuf
beruffsgrupp	bəʀufsgʀup
berühmt	bəʀyːmt
besat	bəsaːt
bësch	bəʃ
bëschaarbechterinne	bəʃaːɐbəɕtəʀinə
beschäftegungssommet	bəʃæftəʑuŋssomeː
beschass	bəʃɑs
bescheed	bəʃeːt
bescheide	bəʃɑɪdə
bescheiden	bəʃɑɪdən
bescheinege	bəʃɑɪnəʑə
bescheinegen	bəʃɑɪnəʑən
beschëllege	bəʃələʑə
beschëllegen	bəʃələʑən
beschiedege	bəʃiədəʑə
beschiedegen	bəʃiədəʑən
beschmiere	bəʃmiːɐʀə
beschmieren	bəʃmiːɐʀən
bëschof	bəʃoːf
beschrëftung	bəʃʀəftuŋ
beschreiwe	bəʃʀɑɪvə
beschreiwen	bəʃʀɑɪvən
beschreiwung	bəʃʀɑɪvuŋ
beschte	bæʃtə
beschten	bæʃtən
beschütze	bəʃytsə
beschützen	bəʃytsən
beschwéiere	bəʃwɜɪəʀə
beschwéieren	bəʃwɜɪəʀən
bëschzerstéierung	bəʃtsɐʃtɜɪəʀuŋ
bësele	bəzələ
bëselen	bəzələn
besetze	bəzætsə
besetzen	bəzætsən
besëtzer	bəzətsɐ
besëtzerinne	bəzətsəʀinə
besiche	bəziɕə
besichen	bəziɕən
besoff	bəzof
besoin	bəzwɛ̃ː
besonnesch	bəzonəʃ
bësse	bəsə
bëssen	bəsən
besser	bæsɐ
besserer	bæsəʀɐ
besseres	bæsəʀəs
besserung	bæsəʀuŋ
besserwësserinne	bæsɐvəsəʀinə
bestelle	bəʃtælə
bestellen	bəʃtælən
bestellung	bəʃtæluŋ
bestëmmt	bəʃtəmt
bestierzung	bəʃtiːɐtsuŋ
bestietnes	bəʃtiətnəs
bestoe	bəʃtoːə
bestoen	bəʃtoːən
bestrofe	bəʃtʀoːfə
bestrofen	bəʃtʀoːfən
bestseller	bæstsælɐ
bestuede	bəʃtuədə
bestueden	bəʃtuədən
bestuet	bəʃtuət
besuch	bəzuχ
besuddele	bəzudələ
besuddelen	bəzudələn
betaaschte	bətaːʃtə
betaaschten	bətaːʃtən
bëtong	bətoŋ
betoune	bətəʊnə
betounen	bətəʊnən
betounung	bətəʊnuŋ
betrib	bətʀiːp
bett	bæt
bettduch	bætduχ
bettseecheschzalot	bætzeːʃəʃtsɑloːt
bettspree	bætʃpʀeː
bevëlkere	bəvəlkəʀə
bewäertungssystem	bəvɛːɐtuŋssiːstəm
bewäis	bəvæːɪs
bewässere	bəvæsəʀə
bewässeren	bəvæsəʀən
bewege	bəveːʑə
bewegen	bəveːʑən
beweise	bəvɑɪzə
beweisen	bəvɑɪzən
bewëllege	bəvələʑə
bewëllegen	bəvələʑən
bewonnere	bəvonəʀə
bewonneren	bəvonəʀən
bewonnereswäert	bəvonəʀəsvɛːɐt
bewonnerung	bəvonəʀuŋ
bewosstlosegkeet	bəvostloːzəɕkeːt
bezéiungsproblem	bətsɜɪuŋspʀobleːm
bezuele	bətsuələ
bezuelen	bətsuələn
bibeltext	bibəltækst
biber	biːbɐ
bibliothecairinne	biblioteːkɛːʀinə
bibliothéik	bibliotɜɪk
bic	bik
bich	biɕ
bichelche	biɕəlɕə
bichelchen	biɕəlɕən
bicherbuttek	biɕɐbutek
bicherschaf	biɕɐʃaːf
bidde	bidə
bidden	bidən
biddo	bidoː
bidet	bideː
biede	biədə
bieden	biədən
biegerinitiativ	bieːʑɐinitsjɑtiːf
bier	biːɐ
bierg	biːɐɕ
biergaarbechterinne	biːɐɕaːɐbəɕtəʀinə
bierger	biːɐʑɐ
biergerinne	biːɐʑəʀinə
biergsteigerinne	biːɐɕʃtɑɪʑəʀinə
bierk	biːɐk
biesem	biəzəm
biffdeck	bifdæk
bigoudi	bigudiː
biischt	biːʃt
bijou	biʒuː
bijouterie	biʒutəʀiː
bild	bilt
bildungschaos	bilduŋskaːos
bille	bilə
billen	bilən
biller	bilɐ
billerbuch	bilɐbuχ
billjee	biljeː
bir	biːɐ
birele	biːʀələ
birelen	biːʀələn
bis	bis
bistro	bistʀoː
bitze	bitsə
bitzen	bitsən
bitzmaschinne	bitsmɑʃinə
biz	biːts
bläi	blæːɪ
bläistëft	blæːɪʃtəft
bläizaldot	blæːɪtsɑldoːt
blaméiere	blɑmɜɪəʀə
blaméieren	blɑmɜɪəʀən
blann	blɑn
bläre	blɛːʀə
blären	blɛːʀən
blat	blaːt
blatzeg	blɑtsəɕ
blech	blæɕ
bléck	blek
bleech	bleːɕ
bléi	blɜɪ
bléie	blɜɪə
bléien	blɜɪən
bléimele	bleːimələ
bléimelen	bleːimələn
bleiwe	blɑɪvə
bleiwen	blɑɪvən
blénke	bleŋkə
blénken	bleŋkən
bless	blæs
blesséiere	blæsɜɪəʀə
blesséieren	blæsɜɪəʀən
blesséierte	blæsɜɪɐtə
blesséierten	blæsɜɪɐtən
blëtz	bləts
blëtze	blətsə
blëtzen	blətsən
blo	bloː
block	blok
blöd	bløːt
bloder	bloːdɐ
bloelzeg	bloːəltsəɕ
blond	blont
blos	bloːs
blose	bloːzə
blosen	bloːzən
blouse	bluːs
bludde	bludə
bludden	bludən
bluddung	bluduŋ
blumm	blum
blummebeet	bluməbeːt
blummebuttek	bluməbutek
blummendëppe	bluməndəpə
blummendëppen	bluməndəpən
blus	bluːs
blutt	blut
bluttaarmutt	bludaːɐmut
bluttdrock	blutdʀok
bobine	bobin
bobinne	bobinə
bockel	bokəl
bockeleg	bokələɕ
bockeleges	bokəlegəs
bocksprange	bokʃpʀɑŋə
bocksprangen	bokʃpʀɑŋən
bokal	bokaːl
boll	bol
bols	bols
boma	boːmaː
bomen	boːmən
bomercher	boːmɐɕɐ
bomi	boːmi
bomien	boːmiːən
bomm	bom
bompele	bompələ
bompelen	bompələn
bon	bɑ̃ː
bongert	boŋɐt
boni	boːni
bonjour	bɑ̃ːʒuːɐ
bonsoir	bɑ̃ːswaːʀ
bonusse	boːnusə
bonzele	bontsələ
bonzelen	bontsələn
boot	boːt
bopa	boːpaː
bor	boːʀ
bord	bɔːʀ
bordüre	bɔʀdyːʀ
borem	boːʀəm
bosnesch	bosnəʃ
bosseg	bosəɕ
botanikerinne	botaːnikəʀinə
botte	bot
botter	botɐ
botz	bots
botze	botsə
botzen	botsən
botzerei	botsəʀɑɪ
botzfra	botsfʀaː
bou	bəʊ
bouaker	bəʊaːkɐ
bouf	bəʊf
bougie	buʒiː
boule	bul
boulette	bulæt
boun	bəʊn
bouquet	bukeː
bouschéisse	bəʊʃɜɪsə
bouschéissen	bəʊʃɜɪsən
bouss	bəʊs
boutique	butik
boutiquë	butikə
box	boks
boxe	boksə
boxen	boksən
boxerinne	boksəʀinə
boycott	boɪkot
braavst	bʀaːfst
braderië	bʀɑdeʀiːə
braderieen	bʀɑdeʀiːən
bräiläffel	bʀæːɪlæfəl
bräitchemann	bʀæːɪtɕemɑn
brak	bʀaːk
brand	bʀɑnt
brandwonn	bʀɑntvon
branntewäin	bʀɑntəvæːɪn
brasseli	bʀɑsəli
bratzele	bʀɑtsəle
bratzelen	bʀɑtsəlen
brauch	bʀæːʊχ
brauche	bʀæːʊχə
brauchen	bʀæːʊχən
brauereisecteur	bʀɑʊəʀɑɪsæktœːʀ
brauereispäerd	bʀɑʊəʀɑɪspɛːɐt
braumeeschterinne	bʀæːʊmeːʃtəʀinə
braut	bʀæːʊt
brautrank	bʀæːʊtʀɑŋk
brav	bʀaːf
braven	bʀaːvən
braver	bʀaːvɐ
bravo	bʀaːvoː
bréck	bʀek
breet	bʀeːt
bréie	bʀɜɪə
bréien	bʀɜɪən
bréif	bʀɜɪf
bréifboîte	bʀɜɪfbwɑt
bréifdréier	bʀɜɪfdʀɜɪɐ
bréifkëscht	bʀɜɪfkəʃt
bréitche	bʀɜɪtɕə
bréitchen	bʀɜɪtɕən
brëll	bʀəl
brëlle	bʀələ
brëllen	bʀələn
brems	bʀæms
bremse	bʀæmzə
bremsen	bʀæmzən
brénge	bʀeŋə
bréngen	bʀeŋən
brenne	bʀænə
brennen	bʀænən
bretelle	bʀətæl
bretonesch	bʀətoːnəʃ
bretze	bʀætsə
bretzeg	bʀætsəɕ
bretzen	bʀætsən
brieche	bʀiəɕə
briechen	bʀiəɕən
briet	bʀiət
briquet	bʀikeː
britt	bʀit
brockelche	bʀokəlɕə
brockelchen	bʀokəlɕən
brode	bʀoːdə
brodéiere	bʀodɜɪəʀə
brodéieren	bʀodɜɪəʀən
broden	bʀoːdən
bromä	bʀomɛː
brong	bʀoŋ
bronkeg	bʀoŋkəɕ
bronz	bʀɑ̃ːs
brooch	bʀoːχ
brooche	bʀoːχə
broochen	bʀoːχən
broscht	bʀoʃt
broschür	bʀoʃyʀ
brot	bʀoːt
brout	bʀəʊt
broutmaschinn	bʀəʊtmɑʃin
brudder	bʀudɐ
brüsk	bʀysk
brutal	bʀutaːl
brutsche	bʀutʃə
brutschen	bʀutʃən
buch	buχ
bucht	buχt
bud	buːt
bude	buːdə
buden	buːdən
budget	bydʒeː
budgetsministerinne	bydʒeːministəʀinə
buedbidde	buətbidə
buedbidden	buətbidən
buede	buədə
buedem	buədəm
bueden	buədən
buedzëmmer	buəttsəmɐ
buedzëmmerschaf	buəttsəmɐʃaːf
buerbes	buːɐbəs
buere	buəʀə
bueren	buəʀən
buerfouss	buːɐfəʊs
buerg	buːɐɕ
buergermeeschter	buəʑɐmeːʃtɐ
buergermeeschterinne	buːɐʑɐmeːʃtəʀinə
buermaschinn	buːɐmɑʃin
buermaschinne	buːɐmɑʃinə
buffet	byfeː
bull	bul
bulli	buli
bullong	buloŋ
bün	byːn
büneshow	byːnəʃəuw
bur	buːʀ
bureau	byʀoː
büro	byʀoː
bürokratesch	byʀoːkʀaːtəʃ
bürosklamer	byʀoːsklaːmɐ
bus	bus
busbilljee	busbiljeː
buschauffer	busʃoːfɐ
buschtaf	buʃtaːf
buschtawéiere	buʃtaːvɜɪəʀə
buschtawéieren	buʃtaːvɜɪəʀən
buslinne	buslinə
bussar	busaːʀ
buttek	butek
butteker	butekɐ
butteksfënster	buteksfənstɐ
butzeg	butsəɕ
cabillaud	kɑbiʒoː
cabine	kɑbin
cabinet	kɑbineː
cabinetspabeier	kɑbineːspɑbɑɪɐ
cabinne	kɑbinə
cadeau	kɑdoː
café	kɑfeː
caissier	keːsjeː
caissière	kæsiɛːʀ
calepin	kɑlpɛ̃ː
camion	kɑmjɑ̃ː
camionette	kɑmjonæt
camionschauffer	kɑmjɑ̃ːsʃoːfɐ
campagne	kɑ̃ːmpɑɲ
campagnë	kɑ̃ːmpɑɲə
campagnen	kɑ̃ːmpɑɲən
campéiere	kæmpɜɪəʀə
campéieren	kæmpɜɪəʀən
canapé	kɑnɑpeː
cantonnier	kɑntonjeː
capot	kɑpoː
cartouche	kɑʀtuʃ
casserole	kɑsəʀol
cassette	kɑsæt
cauchemar	koːʃmaːʀ
cd	tseːdeː
cendrier	sɑ̃ːdʀijeː
chaiselongue	ʃɛːzlɑ̃ːg
chalumeau	ʃɑlymoː
chamberpresidentinne	ʃɑ̃ːmbɐpʀezidæntinə
chamberspresidentinne	ʃɑ̃ːmbɐspʀezidæntinə
champignon	ʃɑ̃ːpiɲɑ̃ː
champion	ʃɑ̃ːpjɑ̃ː
chance	ʃɑ̃ːs
change	ʃɑ̃ːʃ
changéiere	ʃɑ̃ːʒɜɪəʀə
changéieren	ʃɑ̃ːʒɜɪəʀən
chantier	ʃɑ̃ːtjeː
chantieren	ʃɑ̃ːtjeːən
chaotinne	ʃaoːtinə
charmant	ʃɑʀmɑnt
charme	ʃaːʀm
chaudière	ʃoːdjɛːʀ
chauffer	ʃoːfɐ
chef	ʃæf
cheffinne	ʃæfinə
chemesch	ʃeːməʃ
cheminee	ʃmineː
chic	ʃik
chimie	ʃimiː
chinesesch	ʃineːzəʃ
chips	ʃips
chirurginne	ɕiʀuʀʑinə
choix	ʃwɑ
cholerikerinne	koːleːʀikəʀinə
cholesterol	koːlæsteʀol
choufleur	ʃuflœːʀ
chrëschtbeemche	kʀəʃtbeːmɕə
chrëschtbeemchen	kʀəʃtbeːmɕən
chrëschtdag	kʀəʃtdaːχ
chrëschtinne	kʀəʃtinə
chrëschtmaart	kʀəʃtmaːʀt
claude	kloːdə
clementine	kləmɑ̃ːtin
client	kliɑ̃ː
clientèle	kliɑ̃ːtæl
clinique	klinik
clôture	kloːtyːʀ
clown	kloːn
cns	tseːænæs
coiffer	kwɑfɐ
col	kol
collant	kolɑ̃ː
colle	kol
commissairinne	komisɛːʀinə
commissioun	komisjəʊn
communiqué	komynikeː
comptabel	kɑ̃ːtaːbəl
computer	kompjuːtɐ
concert	kɑ̃ːsɛːʀ
concierge	kɑ̃ːsjɛːʀʃ
conciergë	kɑ̃ːsjɛːʀʒə
conciergen	kɑ̃ːsjɛːʀʒən
concours	kɑ̃ːkuːɐ
congé	kɑ̃ːʒeː
contraire	kɑ̃ːtʀɛːʀ
cool	kuːl
copie	kopiː
cornichon	kɔʀniʃɑ̃ː
cortège	kɔʀtɛːʃ
costume	kostym
côte	koːt
coton	kotɑ̃ː
couchen	kuɕən
courage	kuʀaːʃ
couragéiert	kuʀɑʒɜɪɐt
courrier	kuʀjeː
cours	kuːɐ
course	kuʀs
coursemaschinn	kuʀsmɑʃin
coursen	kuːəʀən
coursse	kuʀsə
courssen	kuʀsən
cousin	kuzɛ̃ː
cousine	kuzin
coussin	kusɛ̃ː
couverte	kuvɛːʀə
couverten	kuvɛːʀən
cravate	kʀɑvɑt
crème	kʀɛːm
crevette	kʀəvæt
cric	kʀik
cricket	kʀikeː
croissant	kʀwɑsɑ̃ː
d	d̥
da	dɑ
daach	daːχ
daachdeckerinne	daːχdækəʀinə
daarm	daːɐm
dabo	daːboː
daccord	dɑkɔːʀ
dach	dɑχ
dachs	dɑks
dacks	dɑks
dactylo	dɑktiloː
däerfe	dɛːɐfə
däerfen	dɛːɐfən
daf	daːf
dafstomm	daːfʃtom
dag	daːχ
dagdeeglech	daːχdeːɕləɕ
dagesausflich	daːʒəsæːʊsfliɕ
dagesfahrt	daːʒəsfaːʀt
daierlech	dɑɪɐləɕ
däin	dæːɪn
däischter	dæːɪʃtɐ
däischtert	dæːɪʃtɐt
däitlech	dæːɪtləɕ
däitlechkeet	dæːɪtləɕkeːt
däitsch	dæːɪtʃ
däitschland	dæːɪtʃlɑnt
däiwel	dæːɪvəl
däiwelspakt	dæːɪvəlspɑkt
dall	dɑl
dame	dɑm
damp	dɑmp
dämpe	dæmpə
dämpen	dæmpən
dänesch	dɛːnəʃ
dann	dɑn
dännebam	dænəbaːm
dännebësch	dænəbəʃ
danz	dɑnts
danze	dɑntsə
danzen	dɑntsən
dänzer	dæntsɐ
dänzerin	dæntsəʀin
dänzerinne	dæntsəʀinə
daper	daːpɐ
dar	daːʀ
därbaants	dɛːɐbaːnts
däreldéier	dɛːɐəldɜɪɐ
dat	daːt
datselwecht	daːtzælvəɕt
datt	dɑt
dattel	dɑtəl
datum	daːtum
datz	dɑts
dauche	dæːʊχə
dauchen	dæːʊχən
dauer	dɑʊɐ
dauere	dɑʊəʀə
daueren	dɑʊəʀən
dauf	dɑʊf
daum	dɑʊm
dausend	dɑʊzənt
david	daːvit
de	də
débarras	deːbɑʀaː
deboiséieren	debwɑzɜɪəʀən
debrouilléier	debʀujɜɪɐ
débrouilléiere	debʀujɜɪəʀə
debrouilléieren	dəbʀujɜɪəʀən
debutant	deːbytɑnt
decalage	deːkɑlaːʃ
dech	dəɕ
decharge	dəʃɑʀʃ
décidéiere	deːsidɜɪəʀə
décidéieren	deːsidɜɪəʀən
déck	dek
decke	dækə
deckel	dækəl
decken	dækən
déckflësseg	dekfləsəɕ
déckkäppeg	dekkæpəɕ
declaratioun	deklɑʀatsjəʊn
déclaréiere	deklɑʀɜɪəʀə
déclaréieren	deklɑʀɜɪəʀən
décor	dekɔːʀ
dee	deː
deefe	deːfə
deefen	deːfən
deeg	deːɕ
deeglaang	deːɕlaːŋ
deeglech	deːɕləɕ
deegwuere	deːɕvuːɐʀə
deegwueren	deːɕvuːɐʀən
deel	deːl
deele	deːlə
deelen	deːlən
deelhuele	deːlhuələ
deelhuelen	deːlhuələn
deelweis	deːlvɑɪs
deemno	deːmnoː
deemools	deːmoːls
deen	deːn
deeselwechte	deːzælvəɕtə
deeselwechten	deːzælvəɕtən
déforméiere	defɔʀmɜɪəʀə
déforméieren	defɔʀmɜɪəʀən
defouléiert	dəfulɜɪɐt
déi	dɜɪ
déide	dɜɪdə
déiden	dɜɪdən
deier	dɑɪɐ
déier	dɜɪɐ
déieregaart	dɜɪəʀəgaːʀt
déif	dɜɪf
déift	dɜɪft
déischen	dɜɪsjən
déiselwecht	dɜɪzælvəɕt
déiwin	dɜɪvin
dekret	dəkʀeːt
delegatioun	delegatsjəʊn
delikt	delikt
dëlpessen	dəlpəsən
delphin	dælfiːn
delta	dæltaː
demande	dəmɑ̃ːt
demandë	dəmɑ̃ːtə
demanden	dəmɑ̃ːtən
demandeur	dəmɑ̃ːdœːʀ
demandeuren	dəmɑ̃ːdœːʀən
demaskéier	demɑskɜɪɐ
dementi	dəmæntiː
démodéiert	demodɜɪɐt
demographeschen	demogʀaːfəʃən
demographie	demogʀaːfiː
demonstrant	demonstʀɑnt
demonstrante	demonstʀɑntə
demonstranten	demonstʀɑntən
dëmpe	dəmpə
dëmpen	dəmpən
den	dən
dénger	deŋɐ
déngscht	deŋʃt
denke	dæŋkə
denken	dæŋkən
denkmal	dæŋkmaːl
dënn	dən
dënschdeg	dənʃdəɕ
dënschdege	dənʃdəʑə
dënschdegen	dənʃdəʑən
dënschdes	dənʃdəs
dépanneuse	depɑnøːs
départ	depaːʀ
depassement	dəpɑsəmɑ̃ː
depassemente	dəpɑsəmɑ̃ːə
depassementen	dəpɑsəmɑ̃ːən
dëppe	dəpə
dëppen	dəpən
der	dɐ
derangement	dəʀɑ̃ːʒəmænt
derangementer	dəʀɑ̃ːʒəmæntɐ
derbäi	dɐbæːɪ
dergéint	dɐgɜɪnt
derhannert	dɐhɑnɐt
dermat	dɐmɑt
dernieft	dɐniəft
deroutéier	deʀutɜɪɐ
dervun	dɐfun
derwidder	dɐvidɐ
dës	dəs
desaffectéiert	dezɑfæktɜɪɐt
désagréabel	dezɑgʀeaːbəl
descente	desɑ̃ːt
dësch	dəʃ
dëschelduch	dəʃəlduχ
dëschtel	dəʃtəl
dëse	dəzə
dësen	dəzən
dëslescht	dəslæʃt
dessert	dəsɛːʀ
dëst	dəst
destabiliséieren	destɑbilizɜɪəʀən
desto	dæstoː
detachéiers	detɑʃɜɪɐs
detail	detɑj
detailer	detɑjlɐ
detektivinne	detæktiːvinə
developpementer	dəvəlopəmæntɐ
dezember	detsæmbɐ
dezent	detsænt
dezibel	detsibæl
diagnos	diagnoːs
diagnose	diagnoːzə
diagnostizéieren	diagnostitsɜɪəʀən
dialog	diaːloːχ
dicher	diɕɐ
dicht	diɕt
dichteg	diɕtəɕ
dichterinne	diɕtəʀinə
dichtung	diɕtuŋ
dictée	dikteː
dictéeën	dikteːən
dictionnaire	diksjoːnɛːʀ
die	diə
diebele	diəbələ
diebelen	diəbələn
diedege	diədəʑə
diedegen	diədəʑən
dien	diən
dier	diːɐ
dierfe	diːɐfə
dierfen	diːɐfən
dierwiechterinne	diːɐviəɕtəʀinə
dierze	diːɐtsə
dierzen	diːɐtsən
diesel	diːzəl
diffamatoresch	difɑmɑtoːʀəʃ
digestiffen	diʒestifən
digitaalt	diʒitaːlt
digital	diʒitaːl
diichte	diːɕtə
diichten	diːɕtən
diktatorinne	diktaːtoːʀinə
dilettant	dilætɑnt
dillendapp	diləndɑp
dinde	dɛ̃ːd
dindë	dɛ̃ːdə
dinden	dɛ̃ːdən
diplom	diploːm
diplomatinne	diploːmaːtinə
dir	diːɐ
dirängele	diːʀæŋələ
dirängelen	diːʀæŋələn
direkt	diʀækt
direkter	diʀæktɐ
direktiounssitzung	diʀæktsjəʊnsitsuŋ
dirigéiere	diʀiʒɜɪəʀə
dirigéieren	diʀiʒɜɪəʀən
dirigent	diʀiʒænt
dirigentinne	diʀiʒæntinə
discipline	disiplin
disciplinéierten	disiplinɜɪɐtən
disco	diskoː
discoursen	diskuːəʀən
disponibelen	dispoːnibələn
disque	disk
disquë	diskə
disquen	diskən
distanz	distɑnts
distributeure	distʀibutœːʀə
disziplinne	distsiplinə
diwan	divɑ̃ː
diwwi	diviː
do	doː
dobäi	dobæːɪ
dobanne	dobɑnə
dobannen	dobɑnən
dobausse	dobæːʊsə
dobaussen	dobæːʊsən
dobehalen	doːbəhaːlən
dobleiwen	doːblɑɪvən
doctrinne	doktʀinə
documentairen	dokymɑ̃ːtɛːʀən
dodrun	doːdʀun
doe	doːə
doen	doːən
doft	doft
dohanne	doːhɑnə
dohannen	doːhɑnən
doheem	doːheːm
dohin	doːhin
dokes	doːkəs
dokessen	doːkəsən
dokter	doktɐ
doktesch	doktəʃ
doktrinne	doktʀinə
dokumentéieren	dokumæntɜɪəʀən
dokumentéiers	dokumæntɜɪɐs
dolch	dolɕ
doléiner	doːlɜɪnɐ
dolmetscher	dolmætʃɐ
dolmetscherinne	dolmætʃəʀinə
domat	doːmɑt
domm	dom
dommheet	domheːt
dompeg	dompəɕ
done	dɑ̃ːə
donen	dɑ̃ːən
donieft	doːniəft
donkel	doŋkəl
donner	donɐ
donnerwieder	donɐviədɐ
donneschdeg	donəʃdəɕ
donneschdes	donəʃdəs
dono	doːnoː
donst	donst
doppelgänger	dopəlgæŋɐ
dorobber	doːʀobɐ
doropshi	doːʀopshi
doropshin	doːʀopshin
dosagë	doːzaːʒə
dose	dozə
dosen	dozən
dosis	doːziːs
dot	doːt
douane	dwɑn
douanier	dwɑnjeː
doubléieren	dublɜɪəʀən
douce	duːs
doucë	duːsə
doucem	duːsəm
doucen	duːsən
doucestem	duːsəstəm
douche	duʃ
doud	dəʊt
doudeg	dəʊdəɕ
doudege	dəʊdəʑə
doudegen	dəʊdəʑən
doudelued	dəʊdəluət
doudesannonce	dəʊdəzɑnɑ̃ːs
doudmidd	dəʊtmit
doudsécher	dəʊtzəɕɐ
douéiert	duɜɪɐt
dous	dəʊs
doutgekrasch	dəʊtgəkʀɑʃ
doutgelaacht	dəʊtgəlaːχt
dovun	dofun
draach	dʀaːχ
draguéieren	dʀɑgɜɪəʀən
dräi	dʀæːɪ
dräiavéierzeg	dʀæːɪɑfɜɪɐtsəɕ
dräieck	dʀæːɪek
dräieckeg	dʀæːɪekəɕ
dräirad	dʀæːɪʀaːt
dräizéng	dʀæːɪtseŋ
dram	dʀaːm
dran	dʀɑn
dränke	dʀæŋkə
dränken	dʀæŋkən
drauf	dʀɑʊf
dréche	dʀeɕə
dréchen	dʀeɕən
dréchent	dʀeɕənt
dréchne	dʀeɕnə
dréchnen	dʀeɕnən
dreck	dʀæk
drécke	dʀekə
dreckeg	dʀækəɕ
drécken	dʀekən
dréckerei	dʀekəʀɑɪ
drecksak	dʀæksaːk
dreckskëscht	dʀækskəʃt
dreckstipp	dʀækstip
dreeën	dʀeːən
dreeme	dʀeːmə
dreemen	dʀeːmən
dréie	dʀɜɪə
dréien	dʀɜɪən
dréihälsche	dʀɜɪhælsjə
dréihälschen	dʀɜɪhælsjən
dréngend	dʀeŋənt
drénke	dʀeŋkə
drénken	dʀeŋkən
drénkgeld	dʀeŋkgælt
drénkwaasser	dʀeŋkvaːsɐ
drënner	dʀənɐ
drëpp	dʀəp
drëps	dʀəps
drëpse	dʀəpsə
drëpsen	dʀəpsən
drësseg	dʀəsəɕ
drëtte	dʀətə
drëtten	dʀətən
driibseg	dʀiːpsəɕ
driwwer	dʀivɐ
drobier	dʀoːbiːɐ
drock	dʀok
drocksaach	dʀoksaːχ
droe	dʀoːə
droen	dʀoːən
drog	dʀoːk
drogen	dʀoːgən
drogendealerinne	dʀoːʁəndiːləʀinə
drogenhändlerinne	dʀoːʁənhændləʀinə
drogestatistik	dʀoːʁəʃtɑtistik
drogestatistike	dʀoːʁəʃtɑtistikə
drogestatistiken	dʀoːʁəʃtɑtistikən
droguéieren	dʀoːgɜɪəʀən
droit	dʀwɑ
droleg	dʀoːləɕ
dronkenheet	dʀoŋkənheːt
drop	dʀop
dropgängerinne	dʀopgæŋəʀinə
dropmaache	dʀopmaːχə
dropmaachen	dʀopmaːχən
dropmouchs	dʀopməʊχs
drot	dʀoːt
druddele	dʀudələ
druddelen	dʀudələn
drugéifen	dʀugɜɪfən
drugesaten	dʀugəsaːtən
drüs	dʀyːs
du	duː
dübbelen	dybələn
dübel	dyːbəl
duch	duχ
duché	dyʃeː
ducke	dukə
duckele	dukələ
duckelen	dukələn
ducken	dukən
duebel	duəbəl
duechter	duəɕtɐ
duer	duːɐ
duerch	duːɐɕ
duerchernee	duːɐʑɐneː
duercherneen	duːɐʑɐneːn
duerchfale	duːɐɕfaːlə
duerchfalen	duːɐɕfaːlən
duerchfall	duːɐɕfɑl
duerchgéifen	duːɐɕgɜɪfən
duerchschnëttsalter	duːɐɕʃnətsɑltɐ
duerchsichteg	duːɐɕziɕtəɕ
duerchsträiche	duːɐɕʃtʀæːɪɕə
duerchsträichen	duːɐɕʃtʀæːɪɕən
duerchwulle	duːɐɕvulə
duerchwullen	duːɐɕvulən
duerf	duːɐf
duerfe	duːɐfə
duerfen	duːɐfən
duerfir	duːɐfiːɐ
duergoe	duːɐgoːə
duergoen	duːɐgoːən
duerkomme	duːɐkomə
duerkommen	duːɐkomən
duerno	duːɐnoː
dünger	dyŋɐ
dunn	dun
dure	dyːʀ
dusch	duʃ
duschcabinne	duʃkɑbinə
dusche	duʃə
duschen	duʃən
duschkabinne	duʃkɑbinə
dusel	duzəl
duuscht	duːʃt
duuss	duːs
duze	duːtsə
duzen	duːtsən
dynastie	dinɑstiː
e	ə
ebe	eːbə
eben	eːbən
ecart	ekaːʀ
ecarte	ekaːʀə
ecarten	ekaːʀən
ech	eɕ
echange	eʃɑ̃ːʃ
echangë	eʃɑ̃ːʒə
echangen	eʃɑ̃ːʒən
échantillon	eʃɑ̃ːtijɑ̃ː
echantillon	eʃɑ̃ːtjɑ̃ː
echantillone	eʃɑ̃ːtjɑ̃ːə
echantillonen	eʃɑ̃ːtjɑ̃ːən
echeance	eʃeɑ̃ːs
echeancë	eʃeɑ̃ːsə
echeancen	eʃeɑ̃ːsən
echec	eʃæk
echecke	eʃækə
echecken	eʃækən
echt	æɕt
eck	æk
eckeg	ækəɕ
ecran	eːkʀɑ̃ː
ecrane	eːkʀɑ̃ːə
ecranen	eːkʀɑ̃ːən
edelstee	eːdəlʃteː
edelsteen	eːdəlʃteːn
educatiounsprojeten	eːdukatsjəʊnspʀoʒeːən
ee	eː
eech	eːɕ
eechel	eːɕəl
eed	eːt
eedem	eːdəm
eeërschuel	eːɐʃuəl
eeërstack	eːɐʃtɑk
eefälleg	eːfæləɕ
eefalt	eːfɑlt
eege	eːʑə
eegen	eːʑən
eegentemer	eːʑəntəmɐ
eegentlech	eːʑəntləɕ
eegentom	eːʑəntom
eegiel	eːgiəl
eekele	eːkələ
eekeleg	eːkələɕ
eekelen	eːkələn
eekle	eːklə
eekleg	eːkləɕ
eeklen	eːklən
eelef	eːləf
eeler	eːlɐ
eelst	eːlst
eelste	eːlstə
eelsten	eːlstən
eelze	eːltsə
eelzen	eːltsən
eemer	eːmɐ
eemol	eːmoːl
een	eːn
eenege	eːnəʑə
eenegen	eːnəʑən
eent	eːnt
eenzeg	eːntsəɕ
eenzege	eːntsəʑə
eenzegen	eːntsəʑən
eenzegt	eːntsəɕt
eenzel	eːntsəl
eenzelheete	eːntsəlheːtə
eenzelheeten	eːntsəlheːtən
eenzock	eːntsok
eescht	eːʃt
eeschtlech	eːʃtləɕ
eess	eːs
eeter	eːtɐ
eewäiss	eːvæːɪs
efeu	eːfoɪ
effete	æfeːə
effeten	æfeːən
efficacen	æfikɑsən
efficacer	æfikɑsɐ
efficacest	æfikɑsəst
efficacet	æfikɑst
effiziente	æfitsjænt
effizienter	æfitsjæntɐ
effort	æfɔːʀ
efforte	æfɔːʀə
efforten	æfɔːʀən
egal	egaːl
égout	eguː
eidechs	ɑɪdæks
eidel	ɑɪdəl
éier	ɜɪɐ
éierbar	ɜɪɐbaːʀ
éierewou	ɜɪəʀəwəʊ
éiergäiz	ɜɪɐgæːɪts
éiergäizeg	ɜɪɐgæːɪtsəɕ
éierlech	ɜɪɐləɕ
eigentlech	ɑɪʑəntləɕ
eil	ɑɪl
éil	ɜɪl
einfach	ɑɪnfɑχ
einsamkeet	ɑɪnzaːmkeːt
eintlech	ɑɪntləɕ
eis	ɑɪs
éischt	ɜɪʃt
éischte	ɜɪʃtə
éischten	ɜɪʃtən
éischter	ɜɪʃtɐ
eise	ɑɪzə
eisebunn	ɑɪzebun
eisebunner	ɑɪzebunɐ
eisekuch	ɑɪzekuχ
eisen	ɑɪzən
eisepäertche	ɑɪzəpɛːɐtɕə
eisepäertchen	ɑɪzəpɛːɐtɕən
eiser	ɑɪzɐ
éislek	ɜɪslek
eist	ɑɪst
éisträich	ɜɪstʀæːɪɕ
éiweg	ɜɪvəɕ
éiwegkeet	ɜɪvəɕkeːt
ekel	eːkəl
ekologistinne	eːkoːlogistinə
ekonomistinne	eːkoːnoːmistinə
elaboréieren	elɑboːʀɜɪəʀən
elauter	əlæːʊtɐ
elch	ælɕ
elefeant	ələfɑnt
elei	əlɑɪ
elektriker	elæktʀikɐ
elementar	ələmæntaːʀ
elementarem	ələmæntaːʀəm
elementer	ələmæntɐ
eleng	əlæŋ
elitär	elitɛːʀ
elitären	elitɛːʀən
elle	ælə
ellen	ælən
elo	əloː
eltere	æltəʀə
elteren	æltəʀən
ëm	əm
emäermele	əmɛːɐmələ
emäermelen	əmɛːɐmələn
email	emɑj
émail	emɑj
emailléier	emɑjɜɪɐ
ëmännere	əmænəʀə
ëmänneren	əmænəʀən
emballage	ɑ̃ːmbɑlaːʃ
emballagë	ɑ̃ːmbɑlɑʒə
emballagen	ɑ̃ːmbɑlaːʒən
embargo	æmbɑʀgoː
ëmbloost	əmbloːst
embolie	ɑ̃ːmboliː
ëmbrénge	əmbʀeŋə
ëmbréngen	əmbʀeŋən
embryo	æmbʀioː
embryoe	æmbʀioːə
ëmdréie	əmdʀɜɪə
ëmdréien	əmdʀɜɪən
ëmfang	əmfɑŋ
emfank	əmfɑŋk
emfänke	əmfæŋkə
emfänken	əmfæŋkən
emfindlech	əmfindləɕ
ëmfro	əmfʀoː
emgéigend	əmgɜɪʑənt
ëmgeréits	əmgəʀɜɪts
ëmkomme	əmkomə
ëmkommen	əmkomən
ëmleede	əmleːdə
ëmleeden	əmleːdən
ëmmer	əmɐ
emol	əmoːl
emotionaler	emotsjoːnaːlɐ
emotioun	emotjəʊn
ëmpeg	əmpəɕ
empfaangen	æmpfaːŋən
empfang	æmpfɑŋ
empfindlech	æmpfindləɕ
employé	ɑ̃ːplwɑjeː
emsoss	əmzos
ëmstand	əmʃtɑnt
ëmstousse	əmʃtəʊsə
ëmstoussen	əmʃtəʊsən
ëmwee	əmweː
en	ən
enceinte	ɑ̃ːsɛ̃ːt
endege	ændəʑə
endegen	ændəʑən
endlech	ændləɕ
energie	enɛʀʒiː
eng	æŋ
engagéiere	ɑ̃ːgaːʒɜɪəʀə
engagéieren	ɑ̃ːgaːʒɜɪəʀən
engel	æŋəl
engem	æŋəm
england	æŋlɑnt
englänner	æŋlænɐ
englännerin	æŋlænəʀin
englesch	æŋləʃ
enk	æŋk
enkel	æŋkəl
enkelkand	æŋkəlkɑnt
enn	æn
ënn	ən
ënne	ənə
ënnen	ənən
ënnenan	ənənɑn
ënner	ənɐ
ënnerbrieche	ənɐbʀiəɕə
ënnerbriechen	ənɐbʀiəɕən
ënnerdaach	ənɐdaːχ
ënnergehëlz	ənɐgəhəlts
ënnergoe	ənɐgoːə
ënnergoen	ənɐgoːən
ënnerhale	ənɐhaːlə
ënnerhalen	ənɐhaːlən
ënnerhuele	ənɐhuələ
ënnerhuelen	ənɐhuələn
ënnerläif	ənɐlæːɪf
ënnerriichte	ənɐʀiːɕtə
ënnerriichten	ənɐʀiːɕtən
ënnerscheed	ənɐʃeːt
ënnerscheede	ənɐʃeːdə
ënnerscheeden	ənɐʃeːdən
ënnerschrëft	ənɐʃʀəft
ënnerschreiwe	ənɐʃʀɑɪvə
ënnerschreiwen	ənɐʃʀɑɪvən
ënnersiche	ənɐziɕə
ënnersichen	ənɐziɕən
ënnerstëtzung	ənɐʃtətsuŋ
ënnersträiche	ənɐʃtʀæːɪɕə
ënnersträichen	ənɐʃtʀæːɪɕən
ënnert	ənɐt
ënnertenaner	ənɐtənaːnɐ
ënnerwäsch	ənɐvæʃ
ënnerwee	ənɐveː
ënnerwierfeg	ənɐviəfəɕ
enniichter	əniːɕtɐ
enorm	enɔʀm
entdecke	əntdækə
entdecken	əntdækən
entdeeën	əntdeːən
entfale	əntfaːlə
entfalen	əntfaːlən
enthale	ənthaːlə
enthalen	ənthaːlən
entnäipe	əntnæːɪpə
entnäipen	əntnæːɪpən
entpuppe	əntpupə
entpuppen	əntpupən
entrée	ɑ̃ːtʀeː
entrepreneur	ɑ̃ːtʀəpʀənɐ
entrevue	ɑ̃ːtʀəvyː
entscheede	əntʃeːdə
entscheeden	əntʃeːdən
entschëllege	əntʃələʑə
entschëllegen	əntʃələʑən
entschiedege	əntʃiədəʑə
entschiedegen	əntʃiədəʑən
entschlofe	əntʃloːfə
entschlofen	əntʃloːfən
entwéckele	əntvekələ
entwéckelen	əntvekələn
entwerfe	əntvɛʀfə
entwerfen	əntvɛʀfən
entworf	əntvɔʀf
entwutsche	əntvutʃə
entwutschen	əntvutʃən
entziffere	ənttsifəʀə
entzifferen	ənttsifəʀən
enveloppe	ɑ̃ːvəlop
épicerie	episəʀiː
épicier	episjeː
epidemien	epidemiːən
epilatioun	epilatsjəʊn
epilatioune	epilatsjəʊnə
epilatiounen	epilatsjəʊnən
epiléier	epilɜɪɐ
epilepsie	epileːpsiː
epileptesch	epilæptəʃ
eponge	epɑ̃ːʃ
epongen	epɑ̃ːʒən
eppes	æpəs
epreuve	eːpʀœːf
epreuven	eːpʀœːvən
équipe	ekip
equivalenz	eːkiːvaːlænts
eragoe	əʀɑgoːə
eragoen	əʀɑgoːən
eraklappbar	əʀɑklɑpbaːʀ
erakomme	əʀɑkomə
erakommen	əʀɑkomən
eran	əʀɑn
eraus	əʀæːʊs
erausfanne	əʀæːʊsfɑnə
erausfannen	əʀæːʊsfɑnən
erausgoe	əʀæːʊsgoːə
erausgoen	əʀæːʊsgoːən
eraushuele	əʀæːʊshuələ
eraushuelen	əʀæːʊshuələn
erausklamme	əʀæːʊsklɑmə
erausklammen	əʀæːʊsklɑmən
erauskomme	əʀæːʊskomə
erauskommen	əʀæːʊskomən
erausrappe	əʀæːʊsʀɑpə
erausrappen	əʀæːʊsʀɑpən
erausschëdde	əʀæːʊsʃədə
erausschëdden	əʀæːʊsʃədən
eraussiche	əʀæːʊsziɕə
eraussichen	əʀæːʊsziɕən
erbäilafe	ɐbæːɪlaːfə
erbäilafen	ɐbæːɪlaːfən
erbléckse	ɐbleksə
erblécksen	ɐbleksən
erblose	ɐbloːzə
erblosen	ɐbloːzən
erbrieche	ɐbʀiəɕə
erbriechen	ɐbʀiəɕən
erdiischtere	ɐdiːʃtəʀə
erdiischteren	ɐdiːʃtəʀən
erdrag	ɐdʀaːχ
erdrénke	ɐdʀeŋkə
erdrénken	ɐdʀeŋkən
erdroe	ɐdʀoːə
erdroen	ɐdʀoːən
eréischt	əʀɜɪʃt
erëm	əʀəm
erëmbrénge	əʀəmbʀeŋə
erëmbréngen	əʀəmbʀeŋən
erëmfanne	əʀəmfɑnə
erëmfannen	əʀəmfɑnən
erëmgesi	əʀəmgəzi
erëmgesinn	əʀəmgəzin
erëmgi	əʀəmgi
erëmginn	əʀəmgin
erëmkenne	əʀəmkænə
erëmkennen	əʀəmkænən
erëmkomme	əʀəmkomə
erëmkommen	əʀəmkomən
erëmkréie	əʀəmkʀɜɪə
erëmkréien	əʀəmkʀɜɪən
erënnere	ɐənəʀə
erënneren	ɐənəʀən
erënnerung	ɐənəʀuŋ
erfanne	ɐfɑnə
erfannen	ɐfɑnən
erféiere	ɐfɜɪəʀə
erféieren	ɐfɜɪəʀən
erfolleg	ɐfoləɕ
erfréiere	ɐfʀɜɪəʀə
erfréieren	ɐfʀɜɪəʀən
erhéiung	ɐhɜɪuŋ
erhéngere	ɐheŋəʀə
erhéngeren	ɐheŋəʀən
erhuelung	ɐhuəluŋ
eriwwer	əʀivɐ
eriwwergoe	əʀivɐgoːə
eriwwergoen	əʀivɐgoːən
erkale	ɐkaːlə
erkalen	ɐkaːlən
erkältung	ɐkæltuŋ
erkenne	ɐkænə
erkennen	ɐkænən
erkläre	ɐklɛːʀə
erklären	ɐklɛːʀən
erlaabnes	ɐlaːbnəs
erlaabs	ɐlaːps
erlabe	ɐlaːbə
erlaben	ɐlaːbən
erleedege	ɐleːdəʑə
erleedegen	ɐleːdəʑən
erléise	ɐlɜɪzə
erléisen	ɐlɜɪzən
erliewe	ɐliəvə
erliewen	ɐliəvən
erliichtere	ɐliːɕtəʀə
erliichteren	ɐliːɕtəʀən
ermiddend	ɐmidənt
erneiere	ɐnɑɪəʀə
erneieren	ɐnɑɪəʀən
erniere	ɐniːɐʀə
ernieren	ɐniːɐʀən
ernimme	ɐnimə
ernimmen	ɐnimən
erof	əʀoːf
erofdroe	əʀoːfdʀoːə
erofdroen	əʀoːfdʀoːən
eroffale	əʀoːffaːlə
eroffalen	əʀoːffaːlən
erofgoe	əʀoːfgoːə
erofgoen	əʀoːfgoːən
erofloosse	əʀoːfloːsə
erofloossen	əʀoːfloːsən
erofmaache	əʀoːfmaːχə
erofmaachen	əʀoːfmaːχən
erofrappe	əʀoːfʀɑpə
erofrappen	əʀoːfʀɑpən
erop	əʀop
eropdroe	əʀopdʀoːə
eropdroen	əʀopdʀoːən
eropgoe	əʀopgoːə
eropgoen	əʀopgoːən
eropklamme	əʀopklɑmə
eropklammen	əʀopklɑmən
eropkomme	əʀopkomə
eropkommen	əʀopkomən
erreeche	ɐʀeːɕə
erreechen	ɐʀeːɕən
erreger	ɐʀeːʑɐ
ersatzstéck	ɐzɑtsʃtek
ersaufe	ɐzæːʊfə
ersaufen	ɐzæːʊfən
erschénge	ɐʃeŋə
erschéngen	ɐʃeŋən
ersetze	ɐzætsə
ersetzen	ɐzætsən
erstécke	ɐʃtekə
erstécken	ɐʃtekən
eruewere	ɐuəveʀə
erueweren	ɐuəveʀən
eruewerung	ɐuəvəʀuŋ
ervirdoe	ɐfiːɐdoːə
ervirdoen	ɐfiːɐdoːən
ervirhiewe	ɐfiːɐhiəvə
ervirhiewen	ɐfiːɐhiəvən
erwaarde	ɐvaːʀdə
erwaarden	ɐvaːʀdən
erwaardung	ɐvaːʀduŋ
erwäche	ɐvæɕə
erwächen	ɐvæɕən
erwësche	ɐvəʃə
erwëschen	ɐvəʃən
erwierge	ɐviəʑə
erwiergen	ɐviəʑən
erwuess	ɐvuəs
erwuessene	ɐvuəsənə
erwuessenen	ɐvuəsənən
erzéie	ɐtsɜɪə
erzéien	ɐtsɜɪən
erzéiung	ɐtsɜɪuŋ
erziele	ɐtsiələ
erzielen	ɐtsiələn
erzielung	ɐtsiəluŋ
esch	æʃ
esou	əzəʊ
esoubal	əzəʊbaːl
esouguer	əzəʊguːɐ
esseg	æsəɕ
et	ət
etgen	ətʑən
etikett	etikæt
etlech	ætləɕ
etlechmol	ætləɕmoːl
etüd	eːtyːt
europa	oɪʀoːpaː
europäesch	oɪʀoːpɛːəʃ
ewechbrénge	əvəɕbʀeŋə
ewechbréngen	əvəɕbʀeŋən
ewechgi	əvəɕgi
ewechginn	əvəɕgin
ewechhuele	əvəɕhuələ
ewechhuelen	əvəɕhuələn
ewell	əvæl
exame	ægzaːmə
examen	ægzaːmən
exercice	ægzɐsis
experienz	ækspeʀjænts
expertise	ækspeʀtiːs
export	ækspɔʀt
expositioun	ækspozitsjəʊn
express	ækspʀæs
extere	ækstæʀə
exteren	ækstæʀən
exzellent	æksælænt
faarf	faːɐf
faarfdëppe	faːɐfdəpə
faarfdëppen	faːɐfdəpən
faarweg	faːɐvəɕ
faaschte	faːʃtə
faaschten	faːʃtən
faass	faːs
fabréck	fɑbʀek
fabrizéiere	fɑbʀitsɜɪəʀə
fabrizéieren	fɑbʀitsɜɪəʀən
facteur	fɑktœːʀ
fad	faːt
fäeg	fɛːəɕ
fäert	fɛːɐt
fäerte	fɛːɐtə
fäerten	fɛːɐtən
fal	faːl
fale	faːlə
falen	faːlən
fall	fɑl
fallschierm	fɑlʃiːɐm
falsch	fɑlʃ
fälsche	fælʃə
fälschen	fælʃən
faméis	fɑmɜɪs
familiär	fɑmiljɛːɐ
famill	fɑmil
familljennumm	fɑmiljənnum
fändel	fændəl
fanger	fɑŋɐ
fänke	fæŋkə
fänken	fæŋkən
fanne	fɑnə
fannen	fɑnən
fantastesch	fɑntɑstəʃ
far	faːʀ
fasan	fɑzaːn
fassad	fɑsaːt
fatz	fɑts
fatzeg	fɑtsəɕ
faubourg	foːbuːɐ
faul	fɑʊl
faule	fɑʊlə
faulen	fɑʊlən
faulenze	fæːʊlæntsə
faulenzen	fæːʊlæntsən
fauscht	fæːʊʃt
favoriséiere	fɑvoːʀisɜɪəʀə
favoriséieren	fɑvoːʀisɜɪəʀən
fax	fɑks
februar	feːbʀuaːʀ
fechte	fæɕtə
fechten	fæɕtən
feele	feːlə
feelen	feːlən
feeler	feːlɐ
feescht	feːʃt
feier	fɑɪɐ
feierblumm	fɑɪɐblum
feiere	fɑɪəʀə
féiere	fɜɪəʀə
feieren	fɑɪəʀən
féieren	fɜɪəʀən
feierkuerf	fɑɪɐkuːɐf
feierlech	fɑɪɐləɕ
feierrout	fɑɪɐʀəʊt
feig	fɑɪɕ
feigheet	fɑɪɕheːt
feigling	fɑɪɕliŋ
feil	fɑɪl
feile	fɑɪlə
feilen	fɑɪlən
feind	fɑɪnt
féiwer	fɜɪvɐ
féiwereg	fɜɪvəʀəɕ
feld	fælt
feldhong	fælthoŋ
feldwee	fæltweː
felg	fælɕ
félicitatioun	felisitatsjəʊn
félicitéiere	felisitɜɪəʀə
félicitéieren	felisitɜɪəʀən
fëlle	fələ
fëllen	fələn
fëmme	fəmə
fëmmen	fəmən
fëmmert	fəmɐt
fénkele	feŋkələ
fénkelen	feŋkələn
fënnef	fənəf
fënnefafofzeg	fənəvɑfoftsəɕ
fënnefte	fənəftə
fënneften	fənəftən
fënster	fənstɐ
fernand	fɛʀnɑ̃ː
fernseh	fɛʀnzeː
fësch	fəʃ
fësche	fəʃə
fëschen	fəʃən
fëscher	fəʃɐ
fëscherboot	fəʃɐboːt
fëschfänke	fəʃfæŋkə
fëschfänken	fəʃfæŋkən
fëschmaart	fəʃmaːʀt
fëschrutt	fəʃʀut
fest	fæst
festmaache	fæstmaːχə
festmaachen	fæstmaːχən
feststelle	fæstʃtælə
feststellen	fæstʃtælən
festung	fæstuŋ
fett	fæt
fetteg	fætəɕ
ficelle	fisæl
fiddere	fidəʀə
fidderen	fidəʀən
fieder	fiədɐ
fiederball	fiədɐbɑl
fiels	fiəls
fierchterlech	fiəɕtɐləɕ
fierkel	fiːɐkəl
fierschter	fiəʃtɐ
fierwe	fiːɐvə
fierwen	fiːɐvən
fiffeg	fifəɕ
fiffi	fifiː
fig	fiːk
figur	figuːʀ
fiicht	fiːɕt
fiissche	fiːsjə
fiisschen	fiːsjən
filet	fileː
filial	filjaːl
fille	filə
fillen	filən
film	film
fils	fis
filter	filtɐ
filtere	filtəʀə
filteren	filtəʀən
filz	filts
finale	finɑl
finall	finɑl
firma	fiʀmaː
firmung	fiʀmuŋ
firwat	fiːɐvaːt
fischi	fiʃiː
fisele	fizələ
fiselen	fizələn
fiselree	fizəlʀeː
fiselreen	fizəlʀeːn
fixfeier	fiksfɑɪɐ
fixspoun	fiksʃpəʊn
fize	fiːtsə
fizen	fiːtsən
flaach	flaːχ
flackere	flɑkəʀə
flackeren	flɑkəʀən
fläiss	flæːɪs
fläisse	flæːɪsə
fläisseg	flæːɪsəɕ
fläissen	flæːɪsən
flam	flaːm
flame	flaːmə
flamen	flaːmən
flämesch	flɛːməʃ
flantermaus	flɑntɐmaːus
flantesseg	flɑntəsəɕ
fläsch	flæʃ
fläschelche	flæʃəlɕə
fläschelchen	flæʃəlɕən
flätsch	flætʃ
flauscheg	flæːʊʃəɕ
fleck	flæk
flécke	flekə
flécken	flekən
fleege	fleːʑə
fleegen	fleːʑən
fleesch	fleːʃ
fleeschwollef	fleːʃwoləf
fleete	fleːtə
fleeten	fleːtən
fléie	flɜɪə
fléien	flɜɪən
flemm	flæm
flemmseg	flæmsəɕ
flénk	fleŋk
flënt	flənt
flësseg	fləsəɕ
flicht	fliɕt
fliger	fliːʑɐ
flillek	flilek
flom	floːm
floss	flos
flott	flot
flou	fləʊ
floumaart	fləʊmaːʀt
flu	fluː
fluch	fluχ
fluche	fluχə
fluchen	fluχən
fluchhafen	fluːχhaːfən
flughafe	fluːχhaːfə
flughafen	fluːχhaːfən
flüstere	flystəʀə
flüsteren	flystəʀən
flütt	flyt
fochs	foks
focke	fokə
focken	fokən
fofzeg	foftsəɕ
fofzéng	foftseŋ
föhn	føːn
foire	fwaːʀ
folleche	foləɕə
follechen	foləɕən
folter	foltɐ
fonctionnéiere	foŋksjoːnɜɪəʀə
fonctionnéieren	foŋksjoːnɜɪəʀən
fonke	foŋkə
fonkelnei	foŋkəlnɑɪ
fonken	foŋkən
foosche	foːʃə
fooschen	foːʃən
football	futbɑl
footing	fuːtiŋ
forell	fɔʀæl
form	fɔʀm
forme	fɔʀmə
formen	fɔʀmən
forschette	fɔʀʃæt
fort	fɔʀt
fortfléie	fɔʀtflɜɪə
fortfléien	fɔʀtflɜɪən
fortgoe	fɔʀtgoːə
fortgoen	fɔʀtgoːən
fortlafe	fɔʀtlaːfə
fortlafen	fɔʀtlaːfən
fortschécke	fɔʀtʃekə
fortschécken	fɔʀtʃekən
fotell	foːtæl
foto	fotoː
fotoapparat	fotoːɑpɑʀaːt
fotograf	fotoːgʀaːf
fotografie	fotoːgʀafiː
fouer	fəʊɐ
foulard	fulaːʀ
fouss	fəʊs
foussball	fəʊsbɑl
foussgänger	fəʊsgæŋɐ
foussgängerzon	fəʊsgæŋɐtsoːn
foussteppech	fəʊstæpəɕ
fra	fʀaː
fracht	fʀɑχt
frachtschëff	fʀɑχtʃəf
fräi	fʀæːɪ
fräie	fʀæːɪə
fräien	fʀæːɪən
fräiheet	fʀæːɪheːt
fräiwëlleg	fʀæːɪvələɕ
fräizäit	fʀæːɪtsæːɪt
françois	fʀɑ̃ːswɑ
françoise	fʀɑ̃ːswɑs
frang	fʀɑŋ
frankräich	fʀɑŋkʀæːɪɕ
franséisch	fʀɑnzɜɪʃ
fransous	fʀɑnzəʊs
fräsch	fʀæʃ
fräschmann	fʀæʃmɑn
frascht	fʀɑʃt
fraschtknupp	fʀɑʃtknup
frech	fʀæɕ
freed	fʀeːt
freedefeier	fʀeːdəfɑɪɐ
fréi	fʀɜɪ
freideg	fʀɑɪdəɕ
freides	fʀɑɪdəs
freie	fʀɑɪə
freien	fʀɑɪən
freier	fʀɑɪɐ
fréier	fʀɜɪɐ
fréiere	fʀɜɪəʀə
fréieren	fʀɜɪəʀən
freiesch	fʀɑɪəʃ
fréijor	fʀɜɪjoːʀ
frell	fʀæl
frënd	fʀənt
frëndin	fʀəndin
frëndlech	fʀəndləɕ
frëndschaft	fʀəntʃɑft
frëndschaftlech	fʀəntʃɑftləɕ
frësch	fʀəʃ
frettche	fʀætɕə
frettchen	fʀætɕən
fridde	fʀidə
fridden	fʀidən
friddlech	fʀidləɕ
friem	fʀiəm
frieme	fʀiəmə
friemen	fʀiəmən
friesse	fʀiəsə
friessen	fʀiəsən
frigidaire	fʀiʒidɛːʀ
frigo	fʀigoː
fritt	fʀit
frittebud	fʀitəbuːt
fro	fʀoː
froe	fʀoːə
froen	fʀoːən
fromm	fʀom
fronze	fʀontsə
fronzen	fʀontsən
frou	fʀəʊ
fruchtbar	fʀuχtbaːʀ
fruucht	fʀuːχt
fuddele	fudələ
fuddelen	fudələn
fudder	fudɐ
fuebele	fuəbələ
fuebelen	fuəbələn
fuedem	fuədəm
fuendel	fuəndəl
fuerchtbar	fuːɐɕtbaːʀ
fuerdere	fuːɐdəʀə
fuerderen	fuːɐdəʀən
fuere	fuːɐʀə
fueren	fuːɐʀən
fuerf	fuːɐf
fuersche	fuːɐʃə
fuerschen	fuːɐʃən
fuerweg	fuːɐvəɕ
fuesbal	fuəsbaːl
fuesent	fuəsənt
fueskostüm	fuəskostym
führerschäin	fyːʀɐʃæːɪn
füllfieder	fylfiədɐ
fummele	fumələ
fummelen	fumələn
fusche	fuʃə
fuschen	fuʃən
futti	futi
futur	fytyːʀ
füügt	fyːɕt
fuuss	fuːs
fuusseg	fuːsəɕ
gaangs	gaːŋs
gaapse	gaːpsə
gaapsen	gaːpsən
gaardeboun	gaːʀdəbəʊn
gaardenhaische	gaːʀdənhɑɪsjə
gaardenhaischen	gaːʀdənhɑɪsjən
gaart	gaːʀt
gaascht	gaːʃt
gaaschtfrëndlech	gaːʃtfʀəndləɕ
gaass	gaːs
gäertner	gɛːɐtnɐ
gaffe	gɑf
gäissel	gæːɪsəl
gäizeg	gæːɪtsəɕ
gäizhals	gæːɪtshɑls
gakeg	gaːkəɕ
gal	gaːl
gangster	gæŋstɐ
gank	gɑŋk
gäns	gæns
ganz	gɑnts
gär	gɛːɐ
garage	gɑʀaːʃ
garagë	gɑʀaːʒə
garagen	gɑʀaːʒən
garantéiere	gɑʀɑ̃ːntɜɪəʀə
garantéieren	gɑʀɑ̃ːntɜɪəʀən
garçon	gɑʀsɑ̃ː
gare	gaːʀ
gas	gaːs
gaston	gɑstɑ̃ː
gebai	gəbɑɪ
gebaier	gəbɑɪɐ
gebastels	gəbɑstəls
gebéck	gəbek
gebeess	gəbeːs
gebeessglas	gəbeːsglaːs
gebëss	gəbəs
gebiet	gəbiət
gebills	gəbils
gebilt	gəbilt
gebimmels	gəbiməls
gebitt	gəbit
gebläers	gəblɛːɐs
gebraddels	gəbʀɑdəls
gebräicher	gəbʀæːɪɕɐ
gebräicherlech	gəbʀæːɪɕɐləɕ
gebrauch	gəbʀæːʊχ
gebrode	gəbʀoːdə
gebroden	gəbʀoːdən
gebuert	gəbuːɐt
gebuertsdag	gəbuːɐtsdaːχ
gebuertsdagskaart	gəbuːɐtsdaːχskaːʀt
gebuertsdagskuch	gəbuːɐtsdaːχskuχ
geck	gæk
geckeg	gækəɕ
geckegkeet	gækəɕkeːt
geckenhaus	gækənhæːʊs
geckse	gæksə
gecksen	gæksən
gedeessems	gədeːsəms
gedéiesch	gədɜɪəʃ
gedëlleg	gədələɕ
gedicht	gədiɕt
gedold	gədolt
gedrécks	gədʀeks
gedrénks	gədʀeŋks
gëeegent	gəeːʑənt
geescht	geːʃt
geeschterbunn	geːʃtɐbun
geess	geːs
gefaangene	gəfaːŋənə
gefaangenen	gəfaːŋənən
gefale	gəfaːlə
gefalen	gəfaːlən
gefälleg	gəfæləɕ
gefecht	gəfæɕt
geféierlech	gəfɜɪɐləɕ
gefill	gəfil
gefor	gəfoːʀ
gëft	gəft
gëfteg	gəftəɕ
gehacktes	gəhɑktəs
gehässeg	gəhæsəɕ
geheie	gəhɑɪə
geheien	gəhɑɪən
gehéier	gəhɜɪɐ
gehéiere	gəhɜɪəʀə
gehéieren	gəhɜɪəʀən
geheim	gəhɑɪm
geheimnes	gəhɑɪmnəs
gehir	gəhiːɐ
gei	gɑɪ
géi	gɜɪ
geier	gɑɪɐ
geiereg	gɑɪəʀəɕ
géigend	gɜɪʑənt
géigendeel	gɜɪʑəndeːl
géigner	gɜɪʑnɐ
géint	gɜɪnt
géintiwwer	gɜɪndivɐ
geisel	gɑɪzəl
gejäiz	gəʑæːɪts
gejirimiris	gəʑiʀimiʀis
gekréngelt	gəkʀeŋəlt
gelänner	gəlænɐ
geld	gælt
geleeënheet	gəleːənheːt
geléierte	gəlɜɪɐtə
geléierten	gəlɜɪɐtən
gelldir	gældiːɐ
gëlle	gələ
gëllen	gələn
gelunge	gəluŋə
gelungen	gəluŋən
geméis	gəmɜɪs
gemeng	gəmæŋ
gemittlech	gəmitləɕ
genau	genɑʊ
genéck	gənek
genee	gəneː
genéiere	ʒənɜɪəʀə
genéieren	ʒənɜɪəʀən
genéisse	gənɜɪsə
genéissen	gənɜɪsən
generique	ʒeːneʀik
genn	gæn
genoss	gənos
gënschteg	gənʃtəɕ
genuch	gənuχ
genug	gənuχ
geographie	ʒeːogʀɑfiː
geometer	ʒeːomeːtɐ
gepäck	gəpæk
gérant	ʒeːʀɑ̃ː
gerechterweis	gəʀæɕtɐwɑɪs
géréiere	ʒeːʀɜɪəʀə
géréieren	ʒeːʀɜɪəʀən
gerënne	gəʀənə
gerënnen	gəʀənən
geriicht	gəʀiːɕt
geroch	gəʀoχ
gerode	gəʀoːdə
geroden	gəʀoːdən
gerücht	gəʀyɕt
geschäft	gəʃæft
geschäftlech	gəʃæftləɕ
geschäftsfra	gəʃæftsfʀaː
geschäftsmann	gəʃæftsmɑn
geschéckerlech	gəʃekɐləɕ
gescheet	gəʃeːt
geschéie	gəʃɜɪə
geschéien	gəʃɜɪən
gescheit	gəʃɑɪt
gescheitheet	gəʃɑɪtheːt
geschicht	gəʃiɕt
geschir	gəʃiːɐ
geschmaach	gəʃmaːχ
gëschter	gəʃtɐ
geschützt	gəʃytst
geschwätz	gəʃwæts
geschwë	gəʃwə
geschwënn	gəʃwən
gesellschaft	gəsælʃɑft
gesetz	gəzæts
gesi	gəzi
gesiicht	gəziːɕt
gesinn	gəzin
gesond	gəzont
gesondheet	gəzontheːt
gespaart	gəʃpaːʀt
gespär	gəʃpɛːɐ
gespenst	gəʃpænst
gespréich	gəʃpʀɜɪɕ
gespréicheg	gəʃpʀɜɪɕəɕ
gest	ʒæst
geständnes	gəʃtæntnəs
gestank	gəʃtɑŋk
geste	ʒæst
gestë	ʒæstə
gestell	gəʃtæl
gesträift	gəʃtʀæːɪft
gestrëpp	gəʃtʀəp
getëppelt	gətəpəlt
gette	gætə
getten	gætən
gewalt	gəvɑlt
gewan	gəvaːn
gewanne	gəvɑnə
gewannen	gəvɑnən
gewei	gəvɑɪ
gewéinlech	gəvɜɪnləɕ
gewësse	gəvəsə
gewëssen	gəvəsən
gewëssenhaft	gəvəsənhɑft
gewëssheet	gəvəsheːt
gewier	gəviːɐ
gewierweg	gəviːɐvəɕ
gewierwegkeet	gəviːɐvəɕkeːt
gewierz	gəviːɐts
gewiicht	gəviːɕt
gewulls	gəvuls
gewunnecht	gəvunəɕt
gezei	gətsɑɪ
gi	gi
gidd	git
giedel	giədəl
giedlech	giədləɕ
giel	giəl
gielzecht	giəltsəɕt
gielzeg	giəltsəɕ
gierkse	giːɐksə
gierksen	giːɐksən
giewel	giəvəl
gilet	ʒileː
ginn	gin
gips	gips
gipser	gipsɐ
giraff	ʒiʀɑf
girland	giʀlɑnt
giss	gis
gitar	gitaːʀ
glace	glɑs
glach	glɑχ
gläich	glæːɪɕ
glas	glaːs
glaspabeier	glaːspɑbɑɪɐ
glat	glaːt
glatz	glɑts
glawen	glaːvən
gléck	glek
glécke	glekə
glécken	glekən
glécklech	glekləɕ
gléckwonsch	glekvonʃ
gleewe	gleːvə
gleeweg	gleːvəɕ
gleewen	gleːvən
gleis	glɑɪs
glënnere	glənəʀə
glënneren	glənəʀən
glëtsche	glətʃə
glëtscheg	glətʃəɕ
glëtschen	glətʃən
glidd	glit
gliddeg	glidəɕ
glieschen	gliəsjən
globus	gloːbus
glous	gləʊs
goe	goːə
goen	goːən
gold	golt
goldfësch	goltfəʃ
golf	golf
gomm	gom
gonscht	gonʃt
gorilla	goːʀilaː
gott	got
gottseidank	gotsɑɪdɑŋk
goudron	gudʀɑ̃ː
goungen	gəʊŋən
goungs	gəʊŋs
goungt	gəʊŋt
goureg	gəʊʀəɕ
goût	guː
grad	gʀaːt
graf	gʀaːf
graff	gʀɑf
gräife	gʀæːɪfə
gräifen	gʀæːɪfən
gräisslech	gʀæːɪsləɕ
gramm	gʀɑm
grand	gʀɑ̃ː
granzeg	gʀɑntsəɕ
grapp	gʀɑp
gras	gʀaːs
gratis	gʀaːtis
gratuléiere	gʀɑtulɜɪəʀə
gratuléieren	gʀɑtulɜɪəʀən
grausam	gʀɑʊsaːm
gravéiere	gʀɑvɜɪəʀə
gravéieren	gʀɑvɜɪəʀən
greef	gʀeːf
greeze	gʀeːtsə
greezen	gʀeːtsən
grëff	gʀəf
gréisst	gʀɜɪst
grell	gʀæl
grëndlech	gʀəndləɕ
gréng	gʀeŋ
gréngelzeg	gʀeŋəltsəɕ
grënne	gʀənə
grënnen	gʀənən
grenz	gʀænts
griichesch	gʀiːɕəʃ
grille	gʀilə
grillen	gʀilən
grimass	gʀimɑs
grimmel	gʀiməl
grinse	gʀinzə
grinsen	gʀinzən
gripp	gʀip
gro	gʀoː
groelzeg	gʀoːəltsəɕ
grog	gʀok
grommele	gʀomələ
grommelen	gʀomələn
gromper	gʀompɐ
gromperenzalot	gʀompəʀəntsɑloːt
gromperepurée	gʀompəʀəpyːʀeː
grond	gʀont
grondwaasser	gʀontvaːsɐ
gronn	gʀon
grossist	gʀosist
grott	gʀot
groupe	gʀup
grouss	gʀəʊs
groussaarteg	gʀəʊzaːʀtəɕ
grousseltere	gʀəʊzæltəʀə
grousselteren	gʀəʊzæltəʀən
groussgaass	gʀəʊsgaːs
groussherzog	gʀəʊshɛʀtsoːχ
groussherzogin	gʀəʊshɛʀtsoːgin
groussjäreg	gʀəʊsjɛːʀəɕ
grued	gʀuət
gruef	gʀuəf
gruewe	gʀuəvə
gruewen	gʀuəvən
grujeleg	gʀuʒələɕ
grupp	gʀup
gruppéiere	gʀupɜɪəʀə
gruppéieren	gʀupɜɪəʀən
guckucksblumm	gukuksblum
gued	guət
guergel	guəʑəl
guert	guːɐt
guichet	giʃeː
guidë	giːdə
guide	giːt
guiden	giːdən
guineër	gineːɐ
guineërin	gineːəʀin
gumm	gum
gummi	gumi
güterzuch	gyːtɐtsuχ
gutt	gut
guttaarteg	gudaːʀtəɕ
guttheesche	gutheːʃə
guttheeschen	gutheːʃən
guttheet	gutheːt
haapt	haːpt
haaptsaach	haːptsaːχ
haaptsächlech	haːptsæɕləɕ
haaptstad	haːptʃtaːt
haart	haːʀt
haarz	haːʀts
haascht	haːʃt
haass	haːs
haasse	haːsə
haassen	haːsən
hae	haːə
haen	haːən
häerz	hɛːɐts
häerzche	hɛːɐtsjə
häerzchen	hɛːɐtsjən
häerzeg	hɛːɐtsəɕ
häerzi	hɛːɐtsiː
häerzkrank	hɛːɐtskʀɑŋk
hafe	haːfə
hafen	haːfən
haff	hɑf
haifësch	hɑɪfəʃ
häip	hæːɪp
haische	hɑɪsjə
haischen	hɑɪsjən
hale	haːlə
halen	haːlən
häll	hæl
hall	hɔːl
hallef	hɑləf
hallefnuecht	hɑləfnuəɕt
hallefstonn	hɑləfʃton
hallem	hɑləm
hällewull	hæləvul
hals	hɑls
halschent	hɑlʃənt
halswéi	hɑlsvɜɪ
halt	hɑlt
halwe	hɑlvə
halwen	hɑlvən
halwer	hɑlvɐ
ham	haːm
hambier	hɑmbiːɐ
hamburger	hɑmbuʀgɐ
hämmche	hæmɕə
hämmchen	hæmɕən
hammel	hɑməl
hämmelfleesch	hæməlfleːʃ
hampelmann	hɑmpəlmɑn
hamster	hɑmstɐ
hamstere	hɑmstəʀə
hamsteren	hɑmstəʀən
hand	hɑnt
handduch	hɑntduχ
handele	hɑndələ
handelen	hɑndələn
handgelenk	hɑntgəlæŋk
händler	hændlɐ
händsch	hæntʃ
handschelle	hɑntʃælə
handschellen	hɑntʃælən
handwierker	hɑntviːɐkɐ
handwierksgeschir	hɑntviːɐksgəʃiːɐ
hänk	hæŋk
hänke	hæŋkə
hänken	hæŋkən
hanne	hɑnə
hannelaanscht	hɑnəlaːnʃt
hannen	hɑnən
hannendrun	hɑnəndʀun
hannergrond	hɑnɐgʀont
hannert	hɑnɐt
hannerwands	hɑnɐvɑnts
hannerwenneg	hɑnɐvænəɕ
hannerzeg	hɑnɐtsəɕ
hännes	hænəs
happ	hɑp
har	haːʀ
här	hɛːɐ
harespel	haːʀæspəl
haseleg	hɑzələɕ
haule	hæːʊlə
haulen	hæːʊlən
haus	hæːʊs
hausdéiere	hæːʊsdɜɪəʀə
hausdéieren	hæːʊsdɜɪəʀən
hausdier	hæːʊsdiːɐ
hausfra	hæːʊsfʀaː
hausschlëssel	hæːʊsʃləsəl
haut	hæːʊt
haut	hɑʊt
hautdesdaags	hɑʊtəsdaːχs
héchstens	hekstəns
heck	hæk
hee	heː
heed	heːt
heefeg	heːfəɕ
heehapp	heːhɑp
heekele	heːkələ
heekelen	heːkələn
heel	heːl
heem	heːm
heemele	heːmələ
heemelen	heːmələn
heemfuere	heːmfuːɐʀə
heemfueren	heːmfuːɐʀən
heemgoe	heːmgoːə
heemgoen	heːmgoːən
heemkomme	heːmkomə
heemkommen	heːmkomən
heemlech	heːmləɕ
heepst	heːpst
hees	heːs
heesche	heːʃə
heeschemann	heːʃəmɑn
heeschen	heːʃən
heesprénger	heːʃpʀeŋɐ
hëff	həf
heft	hæft
hei	hɑɪ
heiansdo	hɑɪɑnsdoː
heibanne	hɑɪbɑnə
heibannen	hɑɪbɑnən
heibausse	hɑɪbæːʊsə
heibaussen	hɑɪbæːʊsən
héich	hɜɪɕ
héicht	hɜɪɕt
héiere	hɜɪəʀə
héieren	hɜɪəʀən
héierenk	hɜɪəʀeŋk
heifir	hɑɪfiːɐ
héiflech	hɜɪfləɕ
héiflechkeet	hɜɪfləɕkeːt
heihin	hɑɪhin
héijen	hɜɪʑən
heizkierper	hɑɪtskiəpɐ
heizung	hɑɪtsuŋ
helikopter	helikoptɐ
hell	hæl
hëllef	hələf
hëllefe	hələfə
hëllefen	hələfən
helleg	hæləɕ
hellewech	hæləvæɕ
helm	hælm
hëlze	həltsə
hëlzen	həltsən
hemmung	hæmuŋ
héngerdéif	heŋɐdɜɪf
héngerjuck	heŋɐʑuk
henker	hæŋkɐ
hënner	hənɐ
hënnere	hənəʀə
hënneren	hənəʀən
hënnescht	hənəʃt
hënt	hənt
herno	hɛːɐnoː
herrgott	hɛːɐgot
herrgottsfréi	hɛːɐgotsfʀɜɪ
hetz	hæts
hëtze	hətsə
hëtzen	hətsən
hëtzt	hətst
hex	hæks
hexerei	hæksəʀɑɪ
hick	hik
hickecht	hikəɕt
hidde	hidə
hidden	hidən
hie	hiə
hiecht	hiːəɕt
hiefamm	hiːəvɑm
hiel	hiəl
hielänner	hiəlænɐ
hiem	hiəm
hiemche	hiəmɕə
hiemchen	hiəmɕən
hien	hiən
hier	hiːɐ
hierk	hiːɐk
hierkomme	hiːɐkomə
hierkommen	hiːɐkomən
hierscht	hiːɐʃt
hiert	hiːɐt
hieselnoss	hiəsəlnos
hieselter	hiəzəltɐ
hiewe	hiəvə
hiewel	hiəvəl
hiewen	hiəvən
hifuere	hifuːɐʀə
hifueren	hifuːɐʀən
hikomme	hikomə
hikommen	hikomən
hileeën	hileːən
him	him
himmel	himəl
himmelblo	himəlbloː
himmlesch	himləʃ
hinne	hinə
hinnen	hinən
hinsicht	hinziɕt
hippe	hipə
hippen	hipən
hir	hiːɐ
hirsch	hiʀʃ
hirschuel	hiːɐʃuəl
hisiicht	hiziːɕt
histelle	hiʃtælə
histellen	hiʃtælən
hiwwel	hivəl
hochzäit	hoχtsæːɪt
hochzäitsdag	hoχtsæːɪtsdaːχ
hocker	hokɐ
hoer	hoːɐ
hoerbiischt	hoːɐbiːʃt
hoereg	hoːəʀəɕ
hoffe	hofə
hoffen	hofən
hoffentlech	hofəntləɕ
hoffnung	hofnuŋ
holland	holɑnt
hollännesch	holænəʃ
holz	holts
holzbock	holtsbok
homard	homaːʀ
hond	hont
hondsfrieme	hontsfʀiəmə
hondsfriemen	hontsfʀiəmən
hondsfriesse	hontsfʀiəsə
hondsfriessen	hontsfʀiəsən
hondsgewéinlech	hontsgəvɜɪnləɕ
hondshaische	hontshɑɪsjə
hondshaischen	hontshɑɪsjən
hondsléngt	hontsleŋt
hong	hoŋ
honger	hoŋɐ
hongereg	hoŋəʀəɕ
honnert	honɐt
hörer	høːʀɐ
hotel	oːtæl
houer	həʊɐ
houfert	həʊfɐt
houfreg	həʊfʀəɕ
houscht	həʊʃt
houschte	həʊʃtə
houschten	həʊʃtən
housecker	həʊsekɐ
housse	hus
hu	hu
huddele	hudələ
huddelen	hudələn
huel	huəl
huele	huələ
huelen	huələn
huerele	huːɐʀələ
huerelen	huːɐʀələn
huerteg	huːɐtəɕ
hues	huəs
huesenziwwi	huəsəntsiviː
huewer	huəvɐ
huewerbräi	huəvɐbʀæːɪ
huff	huf
hummer	humɐ
hummere	huməʀə
hummeren	huməʀən
humpe	humpə
humpen	humpən
humus	huːmus
hunn	hun
hunneg	hunəɕ
huppe	hupə
huppen	hupən
hutt	hut
huwwel	huvəl
huwwele	huvələ
huwwelen	huvələn
huwwelspoun	huvəlʃpəʊn
iddi	idiː
iech	iəɕ
ielebou	iələbəʊ
ier	iɐ
ierbes	iɐbəs
ierflech	iɐfləɕ
ierfschaft	iɐfʃɑft
iergend	iɐʑənt
iergendwou	iɐʑəntvəʊ
ierger	iɐʑɐ
iergere	iɐʑəʀə
iergeren	iɐʑəʀən
iergerlech	iɐʑɐləɕ
iertum	iɐtum
ierwe	iɐvə
ierwen	iɐvən
ierz	iɐts
iesel	iəzəl
iesse	iəsə
iessekascht	iəsekɑʃt
iessen	iəsən
iesses	iəsəs
iesswuere	iəsvuːɐʀə
iesswueren	iəsvuːɐʀən
iesszëmmer	iəstsəmɐ
iewel	iəvəl
iewescht	iəvəʃt
ieweschte	iəvəʃtə
ieweschten	iəvəʃtən
igel	igəl
ignoréiere	iɲoːʀɜɪəʀə
ignoréieren	iɲoːʀɜɪəʀən
illusioun	ilusjəʊn
illustréiert	ilustʀɜɪɐt
immens	imæns
impfe	impfə
impfen	impfən
impfung	impfuŋ
import	impɔʀt
indianer	indiaːnɐ
industrie	industʀiː
infam	infaːm
infinitiv	infinitiːf
infirmier	ɛ̃ːfiʀmjeː
informatik	infɔʀmaːtik
ingenieur	ɛ̃ːʒənjœːʀ
insekt	inzækt
insel	inzəl
installateur	ɛ̃ːstɑlɑtœːʀ
instanz	instɑnts
int	int
intche	intɕə
intchen	intɕən
interview	intɛʀvjuː
intim	intiːm
intressant	intʀæsɑnt
intressi	intʀæsi
inversioun	invɛʀzjəʊn
investigatioun	invæstigatsjəʊn
invitatioun	ɛ̃ːvitɑsjəʊn
invitéiere	ɛ̃ːvitɜɪəʀə
invitéieren	ɛ̃ːvitɜɪəʀən
ire	iːʀə
iren	iːʀən
italie	itaːliə
italien	itaːljən
italienesch	itɑljeːnəʃ
iwregens	ivʀəʑəns
iwwel	ivəl
iwwer	ivɐ
iwwerall	ivəʀɑl
iwwerbake	ivɐbaːkə
iwwerbaken	ivɐbaːkən
iwwerbléck	ivɐblek
iwwerdeems	ivɐdeːms
iwwerdreiwe	ivɐdʀɑɪvə
iwwerdreiwen	ivɐdʀɑɪvən
iwwerdroe	ivɐdʀoːə
iwwerdroen	ivɐdʀoːən
iwwerenee	ivəʀəneː
iwwereneen	ivəʀəneːn
iwwerfale	ivɐfaːlə
iwwerfalen	ivɐfaːlən
iwwerfloss	ivɐflos
iwwerfuere	ivɐfuːɐʀə
iwwerfueren	ivɐfuːɐʀən
iwwergi	ivɐgi
iwwerginn	ivɐgin
iwwerhaapt	ivɐhaːpt
iwwerhuele	ivɐhuələ
iwwerhuelen	ivɐhuələn
iwwerleeën	ivɐleːən
iwwerliewe	ivɐliəvə
iwwerliewen	ivɐliəvən
iwwermar	ivɐmaːʀ
iwwermuer	ivɐmuːɐ
iwwerrasche	ivəʀɑʃə
iwwerraschen	ivəʀɑʃən
iwwerraschung	ivəʀɑʃuŋ
iwwerreeche	ivəʀeːɕə
iwwerreechen	ivəʀeːɕən
iwwerrenne	ivəʀænə
iwwerrennen	ivəʀænən
iwwerriede	ivəʀiədə
iwwerrieden	ivəʀiədən
iwwerschrëft	ivɐʃʀəft
iwwerschwemmung	ivɐʃwæmuŋ
iwwersetze	ivɐzætsə
iwwersetzen	ivɐzætsən
iwwersiicht	ivɐziːɕt
iwwersprange	ivɐʃpʀɑŋə
iwwersprangen	ivɐʃpʀɑŋən
iwwerstonn	ivɐʃton
iwwert	ivɐt
iwwerustrengung	ivɐuʃtʀæŋuŋ
iwwerwaache	ivɐvaːχə
iwwerwaachen	ivɐvaːχən
iwwerzeege	ivɐtseːʑə
iwwerzeegen	ivɐtseːʑən
iwwerzeegung	ivɐtseːʑuŋ
ja	jaː
jackett	ʒɑkæt
jäize	ʑæːɪtsə
jäizeg	ʑæːɪtsəɕ
jäizen	ʑæːɪtsən
jalous	ʒɑləʊs
jalousheet	ʒɑləʊsheːt
jalousie	ʒɑluziː
januar	ʑɑnuaːʀ
jarnéier	ʒaːʀnɜɪɐ
jatte	ʒɑt
jauwe	ʑɑʊvə
jauwen	ʑɑʊvən
jeans	dʒiːns
jeeër	jeɐ
jeeërlech	jeːɐləɕ
jéimere	ʑɜɪməʀə
jéimeren	ʑɜɪməʀən
jelli	ʒeli
jéngelche	ʑeŋəlɕə
jéngelchen	ʑeŋəlɕən
jéngste	ʑeŋstə
jéngsten	ʑeŋstən
jesus	jeːzus
jick	ʑik
jicke	ʑikə
jicken	ʑikən
jiddefalls	ʑidəfɑls
jidder	ʑidɐ
jidderee	ʑidəʀeː
jiddereen	ʑidəʀeːn
jiddweree	ʑidfəʀeː
jiddwereen	ʑidfəʀeːn
jilli	ʒiliː
jinsseg	ʑinsəɕ
jo	joː
joe	joːə
joen	joːən
joer	joːɐ
joffer	jofɐ
jogge	dʒogə
joggen	dʒogən
jogurth	juguʀt
jong	joŋ
jonggesell	joŋgəzæl
jongleur	ʒɑ̃ːglœːʀ
jonk	joŋk
jor	joːʀ
jorelaang	joːʀelaːŋ
jorhonnert	joːʀhonɐt
joshgun	ʒoʃgun
journalist	ʒuʀnaːlist
judd	jut
judo	juːdoː
juegd	juəɕt
jugend	juːʁənt
jugendherberg	juːʁənthɛʀbɛʀɕ
juli	ʑuːli
juni	ʑuːni
jupe	ʒyp
jupon	ʒypɑ̃ː
jus	ʒyː
just	ʒust
ka	kɑ
kaart	kaːʀt
kabel	kaːbəl
kabes	kaːbəs
kach	kɑχ
kachbuch	kɑχbuχ
kachcours	kɑχkuːɐ
kachdëppe	kɑχdəpə
kachdëppen	kɑχdəpən
käche	kæɕə
kache	kɑχə
kachegliddeg	kɑχəglidəɕ
kächen	kæɕən
kachen	kɑχən
kachmaschinn	kɑχmɑʃin
kackelack	kɑkəlɑk
kackuett	kɑkwæt
kadaver	kɑdaːvɐ
kader	kaːdɐ
käerche	kɛːɐɕə
käerchen	kɛːɐɕən
käerz	kɛːɐts
kaf	kaːf
kafe	kaːfə
käfeg	kɛːfəɕ
kafen	kaːfən
kaffi	kɑfiː
kaffisbiz	kɑfiːsbiːts
kaffisläffelche	kɑfiːslæfəlɕə
kaffisläffelchen	kɑfiːslæfəlɕən
kaffismille	kɑfiːsmilə
kaffismillen	kɑfiːsmilən
käiche	kæːɪɕə
käichen	kæːɪɕən
kakao	kɑkɑoː
kal	kaːl
kalbass	kɑlbɑs
kalbliddeg	kaːlblidəɕ
kalenner	kɑlænɐ
kall	kɑl
kallef	kɑləf
kalleffleesch	kɑləffleːʃ
kallefskotlett	kɑləfskotlæt
kallek	kɑlek
kalzong	kɑltsoŋ
kamäin	kɑmæːɪn
kaméidi	kɑmɜɪdi
kaméil	kɑmɜɪl
kamell	kɑmæl
kamera	kɑmeːʀaː
kämme	kæmə
kämmen	kæmən
kammoud	kɑməʊt
kammoudheet	kɑməʊtheːt
kamomill	kɑmomil
kamp	kɑmp
kampf	kɑmpf
kämpfe	kæmpfə
kämpfen	kæmpfən
kämpfer	kæmpfɐ
kan	kaːn
kanal	kɑnaːl
kanarievull	kɑnaːʀiəful
kand	kɑnt
kanddaf	kɑntdaːf
kanéngche	kɑneŋɕə
kanéngchen	kɑneŋɕən
känguruh	kæŋguʀuː
kannereg	kɑnəʀəɕ
kannerkutsch	kɑnɐkutʃ
kannerzëmmer	kɑnɐtsəmɐ
kantin	kɑntin
kap	kaːp
kapéiere	kɑpɜɪəʀə
kapéieren	kɑpɜɪəʀən
kaper	kaːpɐ
kapëtche	kɑpətɕə
kapëtchen	kɑpətɕən
kapitel	kɑpitəl
kapp	kɑp
kappkësse	kɑpkəsə
kappkëssen	kɑpkəsən
kappsprong	kɑpʃpʀoŋ
kappwéi	kɑpvɜɪ
kappzich	kɑptsiɕ
kar	kaːʀ
kär	kɛːɐ
karaff	kɑʀɑf
karate	kɑʀaːteː
karblumm	kaːʀblum
karéiert	kɑʀɜɪɐt
kärel	kɛːʀəl
kärgesond	kɛːɐgəzont
karmell	kɑʀmæl
karo	kaːʀoː
karschnatz	kaːʀʃnɑts
kartong	kɑχtoŋ
kartongskëscht	kɑχtoŋskəʃt
kasär	kɑzɛːʀ
käscht	kæʃt
kascht	kɑʃt
kaschte	kɑʃtə
käschtebam	kæʃtəbaːm
kaschten	kɑʃtən
kassett	kɑsæt
kassroll	kɑsʀol
katastrof	kɑtɑstʀoːf
kathoulesch	kɑtəʊləʃ
katze	kɑtsə
katzen	kɑtsən
kaum	kæːʊm
kauzekapp	kæːʊtsəkɑp
kaviar	kɑviaːʀ
kaweechelche	kɑveːɕəlɕə
kaweechelchen	kɑveːɕəlɕən
kaz	kaːts
këddele	kədələ
këddeleg	kədələɕ
këddelen	kədələn
kee	keː
keefer	keːfɐ
keel	keːl
keeleklatz	keːləklɑts
keelt	keːlt
keen	keːn
kees	keːs
keeser	keːzɐ
keess	keːs
kéidreck	kɜɪdʀæk
kéier	kɜɪɐ
keime	kɑɪmə
keimen	kɑɪmən
kéis	kɜɪs
kéisecker	kɜɪsekɐ
kéisrapp	kɜɪsʀɑp
kéistupp	kɜɪʃtup
keller	kælɐ
kellertrap	kælɐtʀaːp
këndche	kəntɕə
këndchen	kəntɕən
keng	kæŋ
kéng	keŋ
kénge	keŋə
kéngen	keŋən
kéngheet	keŋheːt
kënn	kən
kenne	kænə
kënne	kənə
kënneg	kənəɕ
kënnege	kənəʑə
kënnegen	kənəʑən
kennen	kænən
kënnen	kənən
kennschaft	kænʃɑft
kënschtlech	kənʃtləɕ
kënschtler	kənʃtlɐ
këscht	kəʃt
kësse	kəsə
këssen	kəsən
kette	kætə
ketten	kætən
kiche	kiɕə
kichebriet	kiɕəbʀiət
kichelche	kiɕəlɕə
kichelchen	kiɕəlɕən
kichemesser	kiɕəmæsɐ
kichen	kiɕən
kichendësch	kiɕəndəʃ
kichenduch	kiɕənduχ
kicheschaf	kiɕəʃaːf
kichestull	kiɕəʃtul
kichewo	kiɕəvoː
kickele	kikələ
kickelen	kikələn
kidnappéiere	kitnɑpɜɪəʀə
kidnappéieren	kitnɑpɜɪəʀən
kierb	kiːɐp
kierbiischt	kiːɐbiːʃt
kierch	kiːɐɕ
kiere	kiːɐʀə
kieren	kiːɐʀən
kierfche	kiːɐfɕə
kierfchen	kiːɐfɕən
kierfecht	kiːɐfəɕt
kiermes	kiːɐməs
kierper	kiːɐpɐ
kierze	kiːɐtsə
kierzen	kiːɐtsən
kierzlech	kiːɐtsləɕ
kiewerlek	kiəvɐlek
kiischt	kiːʃt
kiischtche	kiːʃtɕə
kiischtchen	kiːʃtɕən
kiischtebam	kiːʃtəbaːm
kill	kil
kille	kilə
killen	kilən
kilo	kiloː
kilometer	kilomeːtɐ
king	kiŋ
kinge	kiŋə
kingen	kiŋən
kinnek	kinek
kinnigin	kinigin
kino	kinoː
kippe	kipə
kippen	kipən
kiselstee	kizəlʃteː
kiselsteen	kizəlʃteːn
kitsch	kitʃ
kitscheg	kitʃəɕ
kiwwel	kivəl
klaatsch	klaːtʃ
klaatsche	klaːtʃə
klaatschen	klaːtʃən
klabbere	klɑbəʀə
klabberen	klɑbəʀən
klack	klɑk
klackespill	klɑkəʃpil
klam	klaːm
klamme	klɑmə
klammen	klɑmən
klape	klaːpə
klapen	klaːpən
klappbar	klɑpbaːʀ
klappe	klɑpə
klappen	klɑpən
kläpperei	klæpəʀɑɪ
klapplued	klɑpluət
klarinett	klɑʀinæt
klass	klɑs
klätsche	klætʃə
klätschen	klætʃən
klatz	klɑts
klatzkapp	klɑtskɑp
klatzkäppeg	klɑtskæpəɕ
klaue	klɑʊə
klauen	klɑʊən
klauschter	klæːʊʃtɐ
kleed	kleːt
kleedche	kleːtɕə
kleedchen	kleːtɕən
kleederbigel	kleːdɐbiʑəl
kleederbiischt	kleːdɐbiːʃt
kleedergeschäft	kleːdɐgəʃæft
kleederschaf	kleːdɐʃaːf
kleedung	kleːduŋ
kleesche	kleːsjə
kleeschen	kleːsjən
kleesper	kleːspɐ
kléi	klɜɪ
kleng	klæŋ
klénge	kleŋə
klengegkeet	klæŋəɕkeːt
kléngen	kleŋən
klenglech	klæŋləɕ
klensch	klænʃ
klëppelsteng	kləpəlʃtæŋ
klibber	klibɐ
klima	kliːmaː
klinik	klinik
klinzeg	klintsəɕ
klippe	klipə
klippen	klipən
klo	kloː
kloe	kloːə
kloen	kloːən
kloer	kloːɐ
klomp	klomp
klotere	kloːtəʀə
kloteren	kloːtəʀən
klouschter	kləʊʃtɐ
kluck	kluk
kludder	kludɐ
klunsch	klunʃ
klunschele	klunʃələ
klunschelen	klunʃələn
knabbele	knɑbələ
knabbelen	knɑbələn
knabbere	knɑbəʀə
knabberen	knɑbəʀən
knache	knɑχə
knachen	knɑχən
knae	knaːə
knaen	knaːən
knäipche	knæːɪpɕə
knäipchen	knæːɪpɕən
knäipe	knæːɪpə
knäipen	knæːɪpən
knapp	knɑp
knäpplach	knæplɑχ
knapps	knɑps
knascht	knɑʃt
knaschteg	knɑʃtəɕ
knätsch	knætʃ
knätsche	knætʃə
knätschen	knætʃən
knätzele	knætsələ
knätzelen	knætsələn
knausereg	knɑʊzəʀəɕ
knéchele	knəɕələ
knéchelen	knəɕələn
knéckeg	knekəɕ
knéckjang	knekʒɑŋ
knéi	knɜɪ
knéie	knɜɪə
knéien	knɜɪən
knéischeif	knɜɪʃɑɪf
knëppel	knəpəl
knëppelsteng	knəpəlʃtæŋ
kniddel	knidəl
kniede	kniədə
knieden	kniədən
kniff	knif
knippche	knipɕə
knippchen	knipɕən
knipse	knipsə
knipsen	knipsən
kniwwele	knivələ
kniwwelen	knivələn
knosp	knosp
knoutere	knəʊtəʀə
knoutereg	knəʊtəʀəɕ
knouteren	knəʊtəʀən
knubbeleg	knubələɕ
knuet	knuət
knuewelek	knuəvəlek
knupp	knup
knuppe	knupə
knuppen	knupən
köder	køːdɐ
koffer	kofɐ
kokett	kokæt
kolleg	koleːɕ
kollegin	koleːʑin
kolonn	kolon
komerod	koməʀoːt
komesch	koːməʃ
komiker	koːmikɐ
komma	komaː
kommandéiere	komɑndɜɪəʀə
kommandéieren	komɑndɜɪəʀən
komme	komə
kommen	komən
kommissioun	komisjəʊn
komp	komp
kompass	kompɑs
kompetenz	kompeːtænts
kompliment	komplimænt
komplizéiert	komplitsɜɪɐt
komplottéiere	komplotɜɪəʀə
komplottéieren	komplotɜɪəʀən
komponist	komponist
konditioun	konditsjəʊn
konfus	konfuːs
konnschaft	konʃɑft
konscht	konʃt
konschtwierk	konʃtviːɐk
konserv	konzɛʀf
konserven	konzɛʀvən
konsonant	konzonɑnt
kont	kont
kontabilitéit	kontɑbilitɜɪt
kontakt	kontɑkt
kontrolléiere	kontʀolɜɪəʀə
kontrolléieren	kontʀolɜɪəʀən
kontroller	kontʀolɐ
kontrolltuerm	kontʀoltuːɐm
kopéiere	kopɜɪəʀə
kopéieren	kopɜɪəʀən
kopi	kopi
koppel	kopəl
kopplabunz	koplɑbunts
kork	koχk
korrespondenten	koʀæspondæntən
koschter	koʃtɐ
koschtere	koʃtəʀə
koschteren	koʃtəʀən
koseng	kozeŋ
kostüm	kostym
kotlett	kotlæt
kotteng	koteŋ
kou	kəʊ
kouert	kəʊɐt
koup	kəʊp
koustall	kəʊʃtɑl
koz	koːts
kraache	kʀaːχə
kraachen	kʀaːχən
kraaft	kʀaːft
krabb	kʀɑp
krabbe	kʀɑbə
krabben	kʀɑbən
kräid	kʀæːɪt
kräijong	kʀæːɪjoŋ
kräische	kʀæːɪʃə
kräischen	kʀæːɪʃən
kräiz	kʀæːɪts
kräize	kʀæːɪtsə
kräizen	kʀæːɪtsən
kräizung	kʀæːɪtsuŋ
krall	kʀɑl
kramp	kʀɑmp
kran	kʀaːn
krank	kʀɑŋk
krankeschwëster	kʀɑŋkəʃwəstɐ
krankheet	kʀɑŋkheːt
krankheetskeim	kʀɑŋkheːtskɑɪm
kranz	kʀɑnts
krapp	kʀɑp
krappeg	kʀɑpəɕ
krauche	kʀæːʊχə
krauchen	kʀæːʊχən
krausel	kʀɑʊzəl
krauseleg	kʀɑʊzələɕ
kraut	kʀæːʊt
krawatt	kʀɑvɑt
kraze	kʀaːtsə
krazen	kʀaːtsən
kréckele	kʀekələ
kréckelen	kʀekələn
kreditkaart	kʀeditkaːʀt
kreemche	kʀeːmɕə
kreemchen	kʀeːmɕən
krees	kʀeːs
kreesch	kʀeːʃ
kregéile	kʀəgɜɪlə
kregéilen	kʀəgɜɪlən
kréi	kʀɜɪ
kréie	kʀɜɪə
kréien	kʀɜɪən
kréiena	kʀɜɪənaː
kréimer	kʀɜɪmɐ
kréischel	kʀɜɪʃəl
kréischelsheck	kʀɜɪʃəlshæk
krëpeng	kʀəpeŋ
krëpp	kʀəp
krëppel	kʀəpəl
krëppeleg	kʀəpələɕ
kretsch	kʀætʃ
krich	kʀiɕ
kriddeleg	kʀidələɕ
kriibs	kʀiːps
krimi	kʀimiː
kristall	kʀistɑl
kriten	kʀiːtən
kritiséiere	kʀitizɜɪəʀə
kritiséieren	kʀitizɜɪəʀən
krokodill	kʀokodil
krom	kʀoːm
kromm	kʀom
krop	kʀoːp
krou	kʀəʊ
kroun	kʀəʊn
krunn	kʀun
kruppschank	kʀupʃɑŋk
krut	kʀuːt
kruten	kʀuːtən
kuch	kuχ
kucke	kukə
kucken	kukən
kuddelfleck	kudəlflæk
kueb	kuəp
kuebe	kuəbə
kueben	kuəbən
kueder	kuədɐ
kuel	kuəl
kuerf	kuːɐf
kuerz	kuːɐts
kuerze	kuːɐtsə
kuerzen	kuːɐtsən
kuerzsichteg	kuːɐtsziɕtəɕ
kugel	kuʁəl
kulang	kulɑŋ
kulisse	kulise
kulissen	kulisen
kummer	kumɐ
künstler	kynstlɐ
kupplung	kupluŋ
kur	kuːɐ
kurzschluss	kuːɐtsʃlus
kuss	kus
kuuscht	kuːʃt
kuuschteg	kuːʃtəɕ
kuuschtert	kuːʃtɐt
laach	laːχ
laache	laːχə
laachen	laːχən
laang	laːŋ
laanscht	laːnʃt
laanschtkomme	laːnʃtkomə
laanschtkommen	laːnʃtkomən
laascht	laːʃt
labber	lɑbɐ
lach	lɑχ
lächele	læɕələ
lächelen	læɕələn
lächerlech	læɕɐləɕ
lackele	lɑkələ
lackeleg	lɑkələɕ
lackelen	lɑkələn
laf	laːf
lafe	laːfə
lafen	laːfən
läffel	læfəl
läffelsgeschir	læfəlsgəʃiːɐ
läich	læːɪɕ
läif	læːɪf
läilech	læːɪləɕ
läinduch	læːɪnduχ
läinzeeche	læːɪntseːɕə
läinzeechen	læːɪntseːɕən
laitue	lɛːtyː
lämmche	læmɕə
lämmchen	læmɕən
land	lɑnt
lande	lɑndə
landen	lɑndən
landkaart	lɑntkaːʀt
landschaft	lɑntʃɑft
landstrooss	lɑntʃtʀoːs
landung	lɑnduŋ
landwirt	lɑntviʀt
länge	læŋə
längen	læŋən
längt	læŋt
langust	lɑŋgust
langweil	lɑŋvɑɪl
langweile	lɑŋvɑɪlə
langweileg	lɑŋvɑɪləɕ
langweilen	lɑŋvɑɪlən
lann	lɑn
lanz	lɑnts
läppche	læpɕə
läppchen	læpɕən
läsche	læʃə
läschen	læʃən
lass	lɑs
lassgi	lɑsgi
lassginn	lɑsgin
lassgoe	lɑsgoːə
lassgoen	lɑsgoːən
lassloosse	lɑsloːsə
lassloossen	lɑsloːsən
lästeg	læstəɕ
lastik	lɑstik
laude	lɑʊdə
lauden	lɑʊdən
lauer	lɑʊɐ
lauere	lɑʊəʀə
laueren	lɑʊəʀən
laufbursch	lɑʊfbuʀʃ
laun	lɑʊn
launesch	lɑʊnəʃ
laus	læːʊs
lauschtere	læːʊʃtəʀə
lauschteren	læːʊʃtəʀən
lauter	læːʊtɐ
lautspriecher	læːʊtʃpʀiəɕɐ
lavabo	lɑvɑboː
lavendel	lɑvændəl
lawin	lɑviːn
lecke	lækə
lecken	lækən
lee	leː
leechne	leːɕnə
leechnen	leːɕnən
leed	leːt
leede	leːdə
leeden	leːdən
leeder	leːdɐ
leeën	leːən
leem	leːm
leeschte	leːʃtə
leeschten	leːʃtən
leeschtung	leːʃtuŋ
lëfte	ləftə
lëften	ləftən
leide	lɑɪdə
leiden	lɑɪdən
leidenschaft	lɑɪdənʃɑft
leider	lɑɪdɐ
leie	lɑɪə
léie	lɜɪə
leien	lɑɪən
léien	lɜɪən
leier	lɑɪɐ
léier	lɜɪɐ
léierbouf	lɜɪɐbəʊf
leiere	lɑɪəʀə
léiere	lɜɪəʀə
leieren	lɑɪəʀən
léieren	lɜɪəʀən
léierin	lɜɪəʀin
léierjong	lɜɪɐjoŋ
léif	lɜɪf
léift	lɜɪft
léine	lɜɪnə
léinen	lɜɪnən
léise	lɜɪzə
léisegeld	lɜɪzəgælt
léisen	lɜɪzən
léislech	lɜɪsləɕ
léisung	lɜɪzuŋ
leit	lɑɪt
leitung	lɑɪtuŋ
léiw	lɜɪf
léiweckelche	lɜɪvækəlɕə
léiweckelchen	lɜɪvækəlɕən
léiwemailche	lɜɪvəmɑɪlɕə
léiwemailchen	lɜɪvəmɑɪlɕən
lektioun	læksjəʊn
lëmmel	ləməl
lëmmelzeg	ləməltsəɕ
léngent	leŋənt
léngt	leŋt
lénks	leŋks
lënnere	lənəʀə
lënneren	lənəʀən
lëns	ləns
leopard	leopaːʀt
lëppestëft	ləpəʃtəft
lëps	ləps
lescht	læʃt
lëscht	ləʃt
leschte	læʃtə
lëschteg	ləʃtəɕ
leschten	læʃtən
lëtzebuerg	lətsəbuːɐɕ
lëtzebuerger	lətsəbuːɐjɐ
lëtzebuergerin	lətsəbuːɐjəʀin
lëtzebuergesch	lətsəbuːɐjəʃ
libell	libæl
liberal	libəʀaːl
librairie	libʀæʀiː
lidd	lit
liddereg	lidəʀəɕ
lidderhanes	lidɐhaːnəs
lieder	liədɐ
liefkuch	liəfkuχ
lies	liəs
liese	liəzə
liesen	liəzən
lieser	liəzɐ
liewe	liəve
lieweg	liəvəɕ
liewen	liəven
liewer	liəveʀ
liewerkniddel	liəveʀknidəl
liewesgeféierlech	liəvesgəfɜɪɐləɕ
lieweskraaft	liəveskʀaːft
liewesmidd	liəvesmit
liewesraum	liəvesʀæːʊm
lift	lift
lige	liʑə
ligen	liʑən
ligener	liʑənɐ
ligestull	liːʑəʃtul
liicht	liːɕt
liichtegkeet	liːɕtəɕkeːt
liichtmëssdag	liːɕtməsdaːχ
liichtsënneg	liːɕtzənəɕ
limonad	limonaːt
lineal	lineaːl
liter	litɐ
living	liviŋ
liwwere	livəʀə
liwweren	livəʀən
liwwerwon	livɐvoːn
lo	loː
locataire	lokɑtɛːʀ
loft	loft
loftballon	loftbɑlɑ̃ː
lokomotiv	lokomotiːf
lokomotiven	lokomotiːvən
lokomotivführer	lokomotiːffyːʀɐ
lomp	lomp
long	loŋ
loosse	loːsə
loossen	loːsən
lorberblat	lɔʀbɐblaːt
losange	lozɑ̃ːʃ
loscht	loʃt
louche	luʃ
loun	ləʊn
loune	ləʊnə
lounen	ləʊnən
lous	ləʊs
loyer	lwɑjeː
luede	luədə
lueden	luədən
luef	luəf
lues	luəs
lupp	lup
lüster	lystɐ
lut	luːt
lutsch	lutʃ
lutsche	lutʃə
lutschen	lutʃən
luucht	luːχt
luuchteschalter	luːχtəʃɑltɐ
luusse	luːsə
luusseg	luːsəɕ
luussen	luːsən
luxuriéis	luksuʀjɜɪs
luxus	luksus
lycée	liseː
ma	mɑ
maache	maːχə
maachen	maːχən
maans	maːns
maart	maːʀt
maartplaz	maːʀtplaːts
mächteg	mæɕtəɕ
mackeg	mɑkəɕ
madame	mɑdɑm
mäerche	mɛɐɕə
mäerchen	mɛɐɕən
mäerder	mɛɐdɐ
mäerderesch	mɛɐdəʀəʃ
mäerz	mɛɐts
magnéit	mɑgnɜɪt
mäifelche	mæːɪfəlɕə
mäifelchen	mæːɪfəlɕən
maillot	mɑjoː
mäin	mæːɪn
malaise	mɑlɛːs
malentendu	mɑlɑ̃ːntɑ̃ːndyː
malle	mɑl
mam	mɑm
mama	mɑmaː
manchett	mɑ̃ːʃæt
mandel	mɑndəl
mandele	mɑndələ
mandelen	mɑndələn
manéierlech	mɑnɜɪɐləɕ
manktem	mɑŋktəm
mann	mɑn
manner	mɑnɐ
mannerjäreg	mɑnɐjɛːʀəɕ
männlech	mænləɕ
mansard	mɑ̃ːsaːʀ
mantel	mɑntəl
mantelbriet	mɑntəlbʀiət
mapp	mɑp
mar	maːʀ
marber	mɑʀbɐ
märei	mæʀɑɪ
märel	mɛːʀəl
margréitche	maːʀgʀɜɪtɕə
margréitchen	maːʀgʀɜɪtɕən
marionett	mɑʀionæt
masch	mɑʃ
mask	mɑsk
maskéieren	mɑskɜɪəʀən
mass	mɑs
massage	mɑsaːʃ
massaker	mɑsɑkɐ
masseg	mɑsəɕ
masseur	mɑsœːʀ
masseuse	mɑsøːs
mast	mɑst
mastik	mɑstik
masutt	mɑzut
mat	mɑt
matbrénge	mɑtbʀeŋə
matbréngen	mɑtbʀeŋən
matdeele	mɑtdeːlə
matdeelen	mɑtdeːlən
matenee	mɑdəneː
mateneen	mɑdəneːn
material	mɑteʀjaːl
matgoe	mɑtgoːə
matgoen	mɑtgoːən
mathematik	mɑtemaːtik
mathuele	mɑthuələ
mathuelen	mɑthuələn
matleed	mɑtleːt
matrass	mɑtʀɑs
matrous	mɑtʀəʊs
matschaffe	mɑtʃɑfə
matschaffen	mɑtʃɑfən
matt	mɑt
mauer	mɑʊɐ
maufel	mæːʊfəl
maulef	mæːʊləf
maulkuerf	mæːʊlkuːɐf
maus	mæːʊs
mauséiercheszalot	mɑʊzɜɪɐɕəstsɑloːt
mécanicien	meːkɑnisjɛ̃ː
mech	məɕ
méchs	məɕs
méck	mek
meckere	mækəʀə
meckeren	mækəʀən
medail	mədɑɪl
medezin	mədətsin
medikament	meːdikɑmænt
mee	meː
meedche	meːtɕə
meedchen	meːtɕən
meederchesnumm	meːdɐɕəsnum
meenung	meːnuŋ
meeréische	meːʀɜɪsjə
meeréischen	meːʀɜɪsjən
meescht	meːʃt
meeschtens	meːʃtəns
meeschter	meːʃtɐ
meessel	meːsəl
meessele	meːsələ
meesselen	meːsələn
mehrzahl	meːɐtsaːl
méi	mɜɪ
meide	mɑɪdə
meiden	mɑɪdən
méie	mɜɪə
méien	mɜɪən
méiglech	mɜɪʑləɕ
méiglechkeet	mɜɪʑləɕkeːt
méiglechst	mɜɪʑləɕst
méimaschinn	mɜɪmɑʃin
méindeg	mɜɪndəɕ
méindes	mɜɪndəs
méintlaang	mɜɪntlaːŋ
méisseg	mɜɪsəɕ
méiw	mɜɪf
méiwe	mɜɪvə
méiwen	mɜɪvən
melde	mældə
melden	mældən
meldung	mælduŋ
mëll	məl
melle	mælə
mëllech	mələɕ
mëllechquoten	mələɕkwoːtən
mëllechzant	mələɕtsɑnt
mellen	mælən
mëller	məlɐ
meloun	mələʊn
mëlz	məlts
member	mɑ̃ːmbɐ
memberen	mɑ̃ːmbəʀən
mëndlech	məndləɕ
mëndlecht	məndləɕt
meng	meŋ
menge	mæŋə
menge	meŋə
mengem	meŋəm
mengen	mæŋən
mengen	meŋən
menger	meŋɐ
mënsch	mənʃ
mënschlech	mənʃləɕ
menu	mənyː
menuskaart	mənyːskaːʀt
mënz	mənts
mer	mɐ
merci	mɛʀsiː
meringue	məʀɛ̃ːŋk
meringuen	məʀɛ̃ːŋgən
mësch	məʃ
mësche	məʃə
mëschen	məʃən
mëscht	məʃt
mëschung	məʃuŋ
message	mæsaːʃ
mëssbrauch	məsbʀæːʊχ
mëssbrauche	məsbʀæːʊχə
mëssbrauchen	məsbʀæːʊχən
messer	mæsɐ
mësserfolleg	məzɐfoləɕ
mëssgeschéck	məsgəʃek
mësstraue	məstʀɑʊə
mësstrauen	məstʀɑʊən
mësstrauesch	məstʀɑʊəʃ
meter	meːtɐ
mëtt	mət
mëtteg	mətəɕ
mëttegiesse	mətəɕiəsə
mëttegiessen	mətəɕiəsən
mëttelméisseg	mətəlmɜɪsəɕ
mëttelste	mətəlstə
mëttelsten	mətəlstən
mëtternuecht	mətɐnuəɕt
mëttes	mətəs
mëttespaus	mətəspɑʊs
mëttesrascht	mətəsʀɑʃt
mëttwoch	mətwoχ
mëttwochs	mətwoχs
metzler	mætslɐ
metzlerei	mætsləʀɑɪ
miaue	miːɑʊə
miauen	miːɑʊən
midd	mit
middegkeet	midəɕkeːt
miel	miəl
mier	miːɐ
mierf	miːɐf
mierke	miːɐkə
mierken	miːɐkən
mierschwéngche	miːɐʃweŋɕə
mierschwéngchen	miːɐʃweŋɕən
mierstär	miːɐʃtɛːɐ
migrän	migʀɛːn
miissche	miːsjə
miisschen	miːsjən
miissercher	miːsɐɕɐ
mikro	mikʀoː
mille	milə
millen	milən
minister	ministɐ
minn	min
minus	miːnus
minutt	minut
mippche	mipɕə
mippchen	mipɕən
mir	miːɐ
misär	mizɛːʀ
miwléiere	mivlɜɪəʀə
miwléieren	miflɜɪəʀən
miwwel	mivəl
mixer	miksɐ
mo	moː
mobiliséiere	mobilizɜɪəʀə
mobiliséieren	mobilizɜɪəʀən
mockeleg	mokələɕ
modell	modæl
modern	modɛʀn
moer	moːɐ
mof	moːf
moie	mojə
moien	mojən
moies	mojəs
mokuch	moːkuχ
mol	moːl
molbier	moːlbiːɐ
mole	moːlə
molen	moːlən
moler	moːlɐ
molstëfter	moːlʃtəftɐ
moment	momænt
momper	mompɐ
mond	mont
mondharmonika	monthɑʀmoːnikaː
moniteur	monitœːʀ
monnerech	monəʀəɕ
monni	moniː
monsieur	məsjøː
monster	monstɐ
montéiere	mɑ̃ːtɜɪəʀə
montéieren	mɑ̃ːtɜɪəʀən
monter	montɐ
monterkeet	montɐkeːt
moolzecht	moːltsəɕt
moos	moːs
mooss	moːs
moosse	moːsə
moossen	moːsən
mopp	mop
mord	mɔʀt
moschter	moʃtɐ
moschtert	moʃtɐt
moss	mos
motivéiere	motivɜɪəʀə
motivéieren	motivɜɪəʀən
motor	motoːʀ
motorboot	motoːʀboːt
motorrad	motoːʀʀaːt
motze	motsə
motzen	motsən
moud	məʊt
mouk	məʊk
mound	məʊnt
mount	məʊnt
moustique	mustik
muckse	muksə
mucksen	muksən
mudder	mudɐ
mudderschrauf	mudɐʃʀɑʊf
mued	muət
muedebëtzeg	muədəbətsəɕ
muele	muələ
muelen	muələn
muer	muːɐ
muerch	muːɐɕ
muere	muːɐʀə
mueren	muːɐʀən
mueres	muːɐʀəs
muert	muːɐt
mull	mul
mullebutz	muləbuts
mumps	mumps
munch	munɕ
munnech	munəɕ
mupp	mup
muschel	muʃəl
musée	myːzeː
musek	muzek
museker	muzekɐ
muskel	muskəl
musse	musə
mussen	musən
muster	mustɐ
mutt	mut
muttwëlleg	mutvələɕ
muttwëlles	mutvələs
mutz	muts
naache	naːχə
naachen	naːχən
naass	naːs
nach	nɑχ
nächst	nɛːkst
nächste	nækstə
nächsten	nækstən
nadja	natjaː
nahrung	naːʀuŋ
näid	næːɪt
näipe	næːɪpə
näipen	næːɪpən
näischnotz	næːɪʃnots
näischnotzeg	næːɪʃnotsəɕ
näischt	næːɪʃt
naiv	naːiːf
namensdag	naːmənsdaːχ
nämlech	nɛːmləɕ
nappe	nɑp
narb	nɑʀp
narbe	nɑʀbə
narben	nɑʀbən
naschele	nɑʃələ
nascheleg	nɑʃələɕ
naschelen	nɑʃələn
nascht	nɑʃt
nashorn	naːshɔʀn
natierlech	nɑtiːɐləɕ
national	nɑtsjoːnaːl
nationalitéit	nɑtsjoːnɑlitɜɪt
natur	nɑtuːʀ
naupe	næːʊpə
naupen	næːʊpən
nawell	nɑvæl
nee	neː
neel	neːl
neelche	neːlɕə
neelchen	neːlɕən
neelchesblumm	neːlɕəsblum
neelcheskapp	neːlɕəskɑp
neele	neːlə
neelen	neːlən
neen	neːn
nees	neːs
nei	nɑɪ
néideg	nɜɪdəɕ
neidesch	nɑɪdəʃ
neiegkeet	nɑɪəɕkeːt
néierens	nɜɪəʀəns
néiesch	nɜɪəʃ
neijooschdag	nɑɪjoːʃdaːχ
neimoudesch	nɑɪməʊdəʃ
néitsche	nɜɪtʃə
néitschen	nɜɪtʃən
néize	nɜɪtsə
néizen	nɜɪtsən
nëmme	nəmə
nëmmen	nəmən
néng	neŋ
néngte	neŋtə
néngten	neŋtən
nerv	nɛʀf
nerve	nɛʀvə
nerven	nɛʀvən
nervös	nɛʀvøːs
nëssert	nəsɐt
net	nət
netz	næts
netze	nætsə
netzen	nætsən
nëtzlech	nətsləɕ
netzt	nætst
neveu	nəvøː
ni	niː
niddereg	nidəʀəɕ
nidderlag	nidɐlaːχ
nidderleeën	nidɐleːən
nidderschloe	nidɐʃloːə
nidderschloen	nidɐʃloːən
nidderträchteg	nidɐtʀæɕtəɕ
nieft	niəft
nier	niːɐ
niere	niːʀə
nieren	niːʀən
nies	niəs
niewebäi	niəvəbæːɪ
niewent	niəvənt
nilpäerd	niːlpɛːɐt
nimools	niːmoːls
niveau	nivoː
niwwel	nivəl
niwweleg	nivələɕ
no	noː
nobäi	noːbæːɪ
nobel	noːbəl
nodeel	noːdeːl
nodenke	noːdæŋkə
nodenken	noːdæŋkən
nogi	noːgi
noginn	noːgin
nogoe	noːgoːə
nogoen	noːgoːən
nohuele	noːhuələ
nohuelen	noːhuələn
nokucke	noːkukə
nokucken	noːkukən
nol	noːl
nolauschtere	noːlæːʊʃtəʀə
nolauschteren	noːlæːʊʃtəʀən
nolauschterer	noːlæːʊʃtəʀɐ
nole	noːlə
noléisseg	noːlɜɪsəɕ
nolen	noːlən
noliese	noːliəzə
noliesen	noːliəzən
nom	noːm
nomëtteg	noːmətəɕ
nomëttes	noːmətəs
nondikass	nondikɑs
nonzeg	nontsəɕ
nonzéng	nontseŋ
noper	noːpɐ
noperschaft	noːpɐʃɑft
nopesch	noːpəʃ
norde	nɔʀdə
norden	nɔʀdən
nördlech	nœʀtləɕ
normal	nɔʀmaːl
noss	nos
notär	notɛːʀ
notéiere	notɜɪəʀə
notéieren	notɜɪəʀən
notiz	notits
notizbuch	notitsbuχ
notze	notsə
notzen	notsən
nout	nəʊt
noutdéngscht	nəʊtdeŋʃt
noutwenneg	nəʊtvænəɕ
noutwennegkeet	nəʊtvænəɕkeːt
nouvelle	nuvæl
november	novæmbɐ
nu	nuː
nuddel	nudəl
nuebel	nuəbəl
nuecht	nuəɕt
nuechtegailche	nuəɕtəgɑɪlɕə
nuechtegailchen	nuəɕtəgɑɪlɕən
nuechtelaang	nuəɕtəlaːŋ
nuechtiesse	nuəʑdiəsə
nuechtiessen	nuəʑdiəsən
nues	nuəs
nueslach	nuəslɑχ
nuets	nuəts
nuetsdësch	nuətsdəʃ
nuetshiem	nuətshiəm
nuetspäiperlek	nuətspæːɪpɐlek
null	nul
numero	numəʀoː
numm	num
nummer	numɐ
ob	op
obwuel	opvuəl
occasioun	okɑzjəʊn
och	oχ
ochs	oks
oder	oːdɐ
ofbotze	oːfbotsə
ofbotzen	oːfbotsən
ofbrenne	oːfbʀænə
ofbrennen	oːfbʀænən
ofdanke	oːfdɑŋkə
ofdanken	oːfdɑŋkən
ofdichte	oːfdiɕtə
ofdichten	oːfdiɕtən
ofdréchne	oːfdʀəɕnə
ofdréchnen	oːfdʀəɕnən
ofdreiwe	oːfdʀɑɪvə
ofdreiwen	oːfdʀɑɪvən
offall	oːffɑl
öffentlech	œfəntləɕ
offréiere	ofʀɜɪəʀə
offréieren	ofʀɜɪəʀən
ofgerënnt	oːfgəʀənt
ofgi	oːfgi
ofginn	oːfgin
ofgoe	oːfgoːə
ofgoen	oːfgoːən
ofgotzele	oːfgotsələ
ofgotzelen	oːfgotsələn
ofhake	oːfhaːkə
ofhaken	oːfhaːkən
ofhale	oːfhaːlə
ofhalen	oːfhaːlən
ofhängeg	oːfhæŋəɕ
ofhängegkeet	oːfhæŋəɕkeːt
ofhänke	oːfhæŋkə
ofhänken	oːfhæŋkən
ofhuele	oːfhuələ
ofhuelen	oːfhuələn
ofkierze	oːfkiːɐtsə
ofkierzen	oːfkiːɐtsən
ofkierzung	oːfkiːɐtsuŋ
ofkille	oːfkilə
ofkillen	oːfkilən
oflafe	oːflaːfə
oflafen	oːflaːfən
ofléis	oːflɜɪs
ofléise	oːflɜɪzə
ofléisen	oːflɜɪzən
ofluede	oːfluədə
oflueden	oːfluədən
ofrappe	oːfʀɑpə
ofrappen	oːfʀɑpən
ofraume	oːfʀɑʊmə
ofraumen	oːfʀɑʊmən
ofrënne	oːfʀənə
ofrënnen	oːfʀənən
ofschafe	oːfʃaːfə
ofschafen	oːfʃaːfən
ofschlécke	oːfʃlekə
ofschlécken	oːfʃlekən
ofschleefe	oːfʃleːfə
ofschleefen	oːfʃleːfən
ofschreiwe	oːfʃʀɑɪvə
ofschreiwen	oːfʃʀɑɪvən
ofschwäche	oːfʃwæɕə
ofschwächen	oːfʃwæɕən
ofso	oːfzoː
ofsoe	oːfzoːə
ofsoen	oːfzoːən
ofspäre	oːfʃpɛːʀə
ofspären	oːfʃpɛːʀən
ofstand	oːfʃtɑnt
ofstänn	oːfʃtæn
ofstreide	oːfʃtʀɑɪdə
ofstreiden	oːfʃtʀɑɪdən
oft	oft
ofwiessele	oːfviəsələ
ofwiesselen	oːfviəsələn
oktober	oktoːbɐ
oliv	oliːf
om	om
omelett	oməlæt
onbedéngt	onbədeŋt
onbestänneg	onbəʃtænəɕ
onbestëmmt	onbəʃtəmt
ondankbar	ondɑŋkbaːʀ
ondenkbar	ondæŋkbaːʀ
onéierlech	onɜɪɐləɕ
onendlech	onændləɕ
onerhéiert	onɐhɜɪɐt
onerwaart	onɐvaːʀt
onfrëndlech	onfʀəndləɕ
ongär	ongɛːɐ
ongedëlleg	ongədələɕ
ongedold	ongədolt
ongeféier	ongəfɜɪɐ
ongemiddelt	ongəmidəlt
ongenéiert	onʒənɜɪɐt
ongeschécklech	ongəʃekləɕ
ongesond	ongəzont
ongewinnt	ongəvint
ongezillt	ongətsilt
ongeziwwer	ongətsivɐ
ongezwonge	ongətswoŋə
ongezwongen	ongətswoŋən
ongläich	onglæːɪɕ
ongléck	onglek
onglécklech	onglekləɕ
onglécklecherweis	onglekləɕɐvɑɪs
onheemlech	onheːmləɕ
onkammoud	onkɑməʊt
onkraut	onkʀæːʊt
onmanéierlech	onmɑnɜɪɐləɕ
onmass	onmɑs
onméiglech	onmɜɪʑləɕ
onnëtz	onəts
onofhängeg	onoːfhæŋəɕ
onofhängegkeet	onoːfhæŋəɕkeːt
onrecht	onʀæɕt
onrou	onʀəʊ
onroueg	onʀəʊəɕ
ons	ons
onschiedlech	onʃiedləɕ
onschold	onʃolt
onsécher	onsəɕɐ
ontrei	ontʀɑɪ
onuerdnung	onuːɐdnuŋ
onvergiesslech	onfɐgiəsləɕ
onverhofft	onfɐhoft
onverschimt	onfɐʃimt
onverschimtheet	onfɐʃimtheːt
onvirsichteg	onfiːɐziɕtəɕ
onvirsichtegkeet	onfiːɐziɕtəɕkeːt
onzefridde	ontsəfʀidə
onzefridden	ontsəfʀidən
ootme	oːtmə
ootmen	oːtmən
ootmung	oːtmuŋ
op	op
opbesserung	opbæsɐuŋ
opblose	opbloːzə
opblosen	opbloːzən
opdrag	opdʀaːχ
opdränge	opdʀæŋə
opdrängen	opdʀæŋən
opdréie	opdʀɜɪə
opdréien	opdʀɜɪən
openthalt	obənthɑlt
oper	oːpɐ
operéiere	opəʀɜɪəʀə
operéieren	opəʀɜɪəʀən
operett	oːpəʀæt
opfale	opfaːlə
opfalen	opfaːlən
opfänke	opfæŋkə
opfänken	opfæŋkən
opfriesse	opfʀiəsə
opfriessen	opfʀiəsən
opgedonnert	opgədonɐt
opgepasst	opgəpɑst
opgi	opgi
opginn	opgin
opgoe	opgoːə
opgoen	opgoːən
ophale	ophaːlə
ophalen	ophaːlən
ophänke	ophæŋkə
ophänken	ophæŋkən
ophiewe	ophiəvə
ophiewen	ophiəvən
opkéipe	opkɜɪpə
opkéipen	opkɜɪpən
opluede	opluədə
oplueden	opluədən
opmierksam	opmiːɐksaːm
opmierksamkeet	opmiːɐksaːmkeːt
oppasse	oppɑsə
oppassen	oppɑsən
oppassert	oppɑsɐt
oppositioun	opozitsjəʊn
oprafe	opʀaːfə
oprafen	opʀaːfən
opraume	opʀɑʊmə
opraumen	opʀɑʊmən
opreege	opʀeːʑə
opreegen	opʀeːʑən
opreegung	opʀeːʑuŋ
oprichteg	opʀiːɕtəɕ
opriichte	opʀiːɕtə
opriichten	opʀiːɕtən
oprulle	opʀulə
oprullen	opʀulən
opschreiwe	opʃʀɑɪvə
opschreiwen	opʃʀɑɪvən
opschuppe	opʃupə
opschuppen	opʃupən
opsiicht	opziːɕt
opsoe	opzoːə
opsoen	opzoːən
opsprange	opʃpʀɑŋə
opsprangen	opʃpʀɑŋən
opstoe	opʃtoːə
opstoen	opʃtoːən
opsuckele	opzukələ
opsuckelen	opzukələn
optiker	optikɐ
opweise	opvɑɪzə
opweisen	opvɑɪzən
opwierme	opwiːɐmə
opwiermen	opwiːɐmən
opwuesse	opwuəsə
opwuessen	opwuəsən
opziele	optsiələ
opzielen	optsiələn
orange	oʀɑ̃ːʃ
orangëjus	oʀɑ̃ːʒəʒyː
organisatioun	ɔʀgaːnizatsjəʊn
organiséiere	ɔʀgaːnizɜɪəʀə
organiséieren	ɔʀgaːnizɜɪəʀən
orthographie	ɔʀtogʀɑfiː
oste	ostə
osten	ostən
otem	oːtəm
otempaus	oːtəmpɑʊs
ouer	əʊɐ
ouerenentzündung	əʊəʀənænttsynduŋ
ouerläppche	əʊɐlæpɕə
ouerläppchen	əʊɐlæpɕən
ouerréng	əʊɐʀeŋ
ouerschlëffer	əʊɐʃləfɐ
ouni	əʊniː
ouschtere	əʊʃtəʀə
ouschteren	əʊʃtəʀən
ouschterhues	əʊʃtɐhuəs
oval	ovaːl
owend	oːvənt
owendiesse	oːvəndiəsə
owendiessen	oːvəndiəsən
ower	oːvɐ
owes	oːvəs
owescours	oːvəskuːɐ
oweskleed	oːvəskleːt
paangech	paːŋəɕ
paart	paːʀt
pabeier	pɑbɑɪɐ
pabeierkuerf	pɑbɑɪɐkuəf
packe	pɑkə
packen	pɑkən
pad	paːt
paddel	pɑdəl
paddelboot	pɑdəlboːt
paddele	pɑdələ
paddelen	pɑdələn
päerd	pɛːɐt
päerdercher	pɛːɐdɐɕɐ
päerdsbier	pɛːɐtsbiːɐ
päerdsstall	pɛːɐtsʃtɑl
paff	pɑf
pai	pɑɪ
päif	pæːɪf
päife	pæːɪfə
päifen	pæːɪfən
paillette	pɑɪæt
päinetsch	pæːɪnætʃ
päiperlek	pæːɪpɐlek
päischte	pæːɪʃtə
päischten	pæːɪʃtən
pak	paːk
pake	paːkə
paken	paːkən
palais	pɑlɛː
palier	pɑlieː
paltong	pɑltoŋ
pampelmuss	pɑmpəlmus
pan	paːn
pand	pɑnt
panda	pɑndaː
panech	paːnəɕ
panewippche	paːnəvipɕə
panewippchen	paːnəvipɕən
pann	pɑn
panz	pɑnts
papagei	pɑpɑgɑɪ
papeg	paːpəɕ
papp	pɑp
paräis	pɑʀæːɪs
parat	pɑʀaːt
paravent	pɑʀɑvɑ̃ː
parcours	pɑʀkuːɐ
pardon	pɑʀdɑ̃ː
parechoc	paːʀʃok
pärel	pɛːʀəl
parfum	pɑʀfɛ̃ː
parfümerie	pɑʀfyməʀiː
park	pɑʀk
parke	pɑʀkə
parken	pɑʀkən
parkplaz	pɑʀkplaːts
parlamentaresch	pɑʀlaːmæntaːʀəʃ
parréck	pɑʀek
participant	pɑʀtisipɑ̃ː
participanten	pɑʀtisipɑ̃ːən
partie	pɑʀtiː
partner	pɑʀtnɐ
party	paːʀtiː
parzeläin	pɑʀtsəlæːɪn
parzell	pɑʀtsæl
paschtouer	pɑʃtəʊɐ
pass	pɑs
passagéier	pɑsɑʒɜɪɐ
passe	pɑsə
passen	pɑsən
passepartout	pɑspɑʀtuː
passette	pɑsæt
passfoto	pɑsfotoː
pater	paːtɐ
patient	pɑtsjænt
patisserie	pɑtisəʀiː
patissier	pɑtisjeː
patsch	pɑtʃ
patt	pɑt
pätter	pætɐ
paus	pɑʊs
pautsch	pæːʊtʃ
pawee	pɑveː
péage	peːaːʃ
pech	pæɕ
peche	pæɕə
pecheg	pæɕəɕ
pechen	pæɕən
pedall	pədɑl
pédicure	peːdikyːʀ
peffer	pæfɐ
peffermanztéi	pæfɐmɑntstɜɪ
péiteng	pɜɪteŋ
péiterséilech	pɜɪtɐzɜɪləɕ
pelikan	peːlikaːn
pëll	pəl
pellem	pæləm
pelz	pælts
péng	peŋ
péngeche	peŋəɕə
péngechen	peŋəɕən
péngschte	peŋʃtə
péngschten	peŋʃtən
penibel	peːniːbəl
péniche	peːniʃ
pénktlech	peŋktləɕ
pensée	pɑ̃ːseː
pënsel	pənzəl
pensionéiert	pænsjoːnɜɪɐt
pëppel	pəpəl
perfekt	pɛʀfækt
permanente	pɛʀmɑnɑ̃ːt
permis	pɛʀmiː
perruche	pæʀyʃ
perséinlech	pɛʀzɜɪnləɕ
personal	pɛʀzonaːl
persoun	pɛʀzəʊn
pescht	pæʃt
pëspere	pəspəʀə
pësperen	pəspəʀən
pëtrolstanker	pətʀolstɑŋkɐ
pëtz	pəts
pëtze	pətsə
pëtzen	pətsən
petzi	pætsiː
phare	faːʀ
phonetik	foneːtik
piano	pjɑnoː
picke	pikə
pickeg	pikəɕ
picken	pikən
picknick	piknik
piddele	pidələ
piddelen	pidələn
piff	pif
piisch	piːʃ
pije	piːʒə
pijen	piːʒən
pilger	pilʑɐ
pilgerplaz	pilʑɐplaːts
pillem	piləm
pilot	piloːt
pilz	pilts
pinguin	piŋguiːn
pinsche	pinʃə
pinschen	pinʃən
pinsel	pinzəl
piscine	pisin
pisse	pisə
pissen	pisən
pist	pist
pittoresk	pitoːʀæsk
pizza	pitsaː
placard	plɑkaːʀ
plack	plɑk
plackespiller	plɑkəʃpilɐ
plädéiere	plɛːdɜɪəʀə
plädéieren	plɛːdɜɪəʀən
plafong	plɑfoŋ
plafonnéier	plɑfonɜɪɐ
plage	plaːʃ
plagen	plaːʒən
plakapp	plaːkɑp
plakäppeg	plaːkæpəɕ
plakat	plɑkaːt
plakeg	plaːkəɕ
planéiere	plɑnɜɪəʀə
planéieren	plɑnɜɪəʀən
planet	plɑneːt
plang	plɑŋ
plange	plɑŋə
plangen	plɑŋən
planz	plɑnts
planze	plɑntsə
planzen	plɑntsən
plastik	plɑstik
plastikstut	plɑstikstuːt
plastilin	plɑstilin
plateau	plɑtoː
plätschnaass	plætʃnaːs
platt	plɑt
plättche	plætɕə
plättchen	plætɕən
platte	plɑtə
platten	plɑtən
platze	plɑtsə
platzen	plɑtsən
plaz	plaːts
plécke	plekə
plécken	plekən
plënnere	plənəʀə
plënneren	plənəʀən
pleséier	pləzɜɪɐ
plo	ploː
ploe	ploːə
ploen	ploːən
plomm	plom
plooschter	ploːʃtɐ
plott	plot
plou	pləʊ
ploue	pləʊə
plouen	pləʊən
plover	ploːvɐ
plüschdéier	plyʃdɜɪɐ
pneu	pnøː
pohunn	poːhun
poléiere	polɜɪəʀə
poléieren	polɜɪəʀən
police	polis
politiker	politikɐ
polizei	politsɑɪ
polizist	politsist
polnesch	polnəʃ
polstere	polstəʀə
polsteren	polstəʀən
polver	polfɐ
polykopéiere	polikopɜɪəʀə
polykopéieren	polikopɜɪəʀən
pompel	pompəl
pompele	pompələ
pompelen	pompələn
pompjee	pompʒeː
pompjeesauto	pompʒeːzɑʊtoː
pond	pont
pony	poniː
popcorn	popkɔːʀn
popp	pop
poppenhaus	popənhæːʊs
porrett	pɔʀæt
portefeuille	pɔʀtəfœj
portemanteau	pɔʀtmɑ̃ːtoː
portier	pɔʀtjeː
portioun	pɔʀtsjəʊn
portmonni	pɔʀtmoniː
portugal	pɔʀtuːgɑl
portugisesch	pɔʀtugiːzəʃ
posch	poʃ
post	post
poteau	potoː
potere	poːtəʀə
poteren	poːtəʀən
potti	potiː
poufank	pəʊfɑŋk
pouke	pəʊkə
pouken	pəʊkən
poul	pəʊl
poulet	puleː
poulriicht	pəʊlʀiːɕt
poussette	pusæt
pouster	pəʊstɐ
pouze	pəʊtsə
pouzen	pəʊtsən
prabbeli	pʀɑbəliː
praffe	pʀɑfə
praffen	pʀɑfən
präis	pʀæːɪs
praktesch	pʀɑktəʃ
praum	pʀɑʊm
praxis	pʀɑksis
präzis	pʀɛːtsiːs
préiwe	pʀɜɪvə
préiwen	pʀɜɪvən
premiere	pʀəmjeːə
première	pʀəmjɛːʀ
prënz	pʀənts
préparatioun	pʀeːpɑʀɑtjəʊn
presentatioun	pʀezɑ̃ːntatsjəʊn
presentéieren	pʀezɑ̃ːntɜɪəʀən
presse	pʀæsə
pressen	pʀæsən
pressessioun	pʀæsəsjəʊn
pressioun	pʀæsjəʊn
presslofthummer	pʀæslofthumɐ
prêt	pʀɛː
prett	pʀæt
preuven	pʀœːvən
priedege	pʀiədəʑə
priedegen	pʀiədəʑən
primärschoul	pʀimɛːɐʃəʊl
prinzessin	pʀintsæsin
prisong	pʀizoŋ
prisonnéier	pʀizonɜɪɐ
privat	pʀivaːt
pro	pʀoː
probéiere	pʀobɜɪəʀə
probéieren	pʀobɜɪəʀən
problem	pʀobleːm
produkt	pʀodukt
produktioun	pʀoduksjəʊn
produzéiere	pʀodutsɜɪəʀə
produzéieren	pʀodutsɜɪəʀən
professer	pʀofæsɐ
professesch	pʀofæsəʃ
profezeie	pʀofətsɑɪə
profezeien	pʀofətsɑɪən
profit	pʀofit
profitéiere	pʀofitɜɪəʀə
profitéieren	pʀofitɜɪəʀən
programm	pʀogʀɑm
programméiere	pʀogʀɑmɜɪəʀə
programméieren	pʀogʀɑmɜɪəʀən
progrès	pʀogʀɛː
projet	pʀoʒeː
projeten	pʀoʒeːən
projets	pʀoʒeː
proklaméiere	pʀoklɑmɜɪəʀə
proklaméieren	pʀoklɑmɜɪəʀən
prominent	pʀominænt
promm	pʀom
pronom	pʀonɑ̃ː
pronome	pʀonɑ̃ːə
pronomen	pʀonɑ̃ːən
propeller	pʀopælɐ
proposéiere	pʀopoːzɜɪəʀə
proposéieren	pʀopoːzɜɪəʀən
propper	pʀopɐ
propretéit	pʀopʀətɜɪt
prospekt	pʀospækt
prost	pʀost
proste	pʀostə
prosten	pʀostən
protein	pʀoteːiːn
prouwe	pʀəʊvə
prouwen	pʀəʊvən
prozent	pʀotsænt
pruecht	pʀuəɕt
prüfung	pʀyːfuŋ
psalm	psaːlm
psychanalys	psikɑnaːliːs
psychesch	psiːɕəʃ
psychescher	psiɕəʃɐ
psychiater	psikjaːtɐ
psychiatresch	psikjaːtʀəʃ
psychoanalys	psikoːɑnaːliːs
psychoanalyse	psikoːɑnaːliːzə
psychologie	psikoːloːʒiː
psychos	psikoːs
publicitéit	pyblisitɜɪt
publizéiere	pyblitsɜɪəʀə
publizéieren	pyblitsɜɪəʀən
puche	puχə
puchen	puχən
pudder	pudɐ
puddere	pudəʀə
pudderen	pudəʀən
puer	puːɐ
puff	puf
puffe	pufə
puffen	pufən
puffere	pufəʀə
pufferen	pufəʀən
pujel	puʒəl
pull	pul
pullover	puloːvɐ
pünäs	pynɛːs
punkt	puŋkt
pupeg	puːpəɕ
puppelche	pupəlɕə
puppelchen	pupəlɕən
puppsat	pupzaːt
purée	pyːʀeː
putsch	putʃ
pyjama	piʒaːmaː
quai	kɛː
quake	kwaːkə
quaken	kwaːkən
quäle	kwɛːlə
quälen	kwɛːlən
qualitéit	kɑlitɜɪt
quantitéit	kɑntitɜɪt
quartier	kɑʀtjeː
quatsch	kwɑtʃ
queesch	kweːʃ
quell	kwæl
quetsch	kwætʃ
quetschekraut	kwætʃəkʀæːʊt
queue	køː
quiitsche	kwiːtʃə
quiitschen	kwiːtʃən
quittung	kwituŋ
raache	ʀaːχə
raachen	ʀaːχən
raaspel	ʀaːspəl
raaspele	ʀaːspələ
raaspelen	ʀaːspələn
rabatt	ʀɑbɑt
rabbele	ʀɑbələ
rabbelen	ʀɑbələn
räbbi	ʀæbiː
rabbiner	ʀɑbinɐ
rach	ʀɑχ
räche	ʀɛːɕə
rächen	ʀɛːɕən
rack	ʀɑk
rad	ʀaːt
radau	ʀɑdɑʊ
raddereg	ʀɑdəʀəɕ
radio	ʀaːdjoː
rafe	ʀaːfə
rafen	ʀaːfən
raffinéiert	ʀɑfinɜɪɐt
rahm	ʀaːm
raiber	ʀɑɪbɐ
räich	ʀæːɪɕ
räichtum	ʀæːɪɕtum
räif	ʀæːɪf
räis	ʀæːɪs
rakéit	ʀɑkɜɪt
rambli	ʀɑmbliː
rang	ʀɑŋ
rank	ʀɑŋk
rapp	ʀɑp
rappe	ʀɑpə
rappecht	ʀɑpəɕt
rappen	ʀɑpən
rapport	ʀɑpɔːʀ
räpse	ʀæpsə
räpsen	ʀæpsən
raquette	ʀɑkæt
rar	ʀaːʀ
rascht	ʀɑʃt
raschte	ʀɑʃtə
raschteg	ʀɑʃtəɕ
raschten	ʀɑʃtən
rass	ʀɑs
rat	ʀaːt
rätsel	ʀɛːtsəl
rau	ʀæːʊ
raum	ʀæːʊm
raume	ʀɑʊmə
raumen	ʀɑʊmən
raumschëff	ʀæːʊmʃəf
raup	ʀæːʊp
raut	ʀæːʊt
razeg	ʀaːtsəɕ
reaktioun	ʀeaːksjəʊn
réaliséiere	ʀeaːlizɜɪəʀə
réaliséieren	ʀeaːlizɜɪəʀən
rebbi	ʀæbiː
réceptionniste	ʀeːsæpsjoːnist
receptioun	ʀeːsæpsjəʊn
rechemaschinn	ʀæɕəmɑʃin
recherche	ʀəʃɛʀʃ
rechne	ʀæɕnə
rechnen	ʀæɕnən
rechnung	ʀæɕnuŋ
recht	ʀæɕt
rechts	ʀæɕts
réck	ʀek
réckele	ʀekələ
réckelen	ʀekələn
ree	ʀeː
reebou	ʀeːbəʊ
reech	ʀeːɕ
reeche	ʀeːɕə
reechen	ʀeːɕən
reedel	ʀeːdəl
reef	ʀeːf
reell	ʀeːæl
reemantel	ʀeːmɑntəl
reen	ʀeːn
reene	ʀeːnə
reeneg	ʀeːnəɕ
reenen	ʀeːnən
rees	ʀeːs
reese	ʀeːzə
reesen	ʀeːzən
reewaasser	ʀeːwaːsɐ
reewuerm	ʀeːvuːɐm
refuséiere	ʀəfyzɜɪəʀə
refuséieren	ʀəfyzɜɪəʀən
regard	ʀəgaːʀ
regel	ʀeːʑəl
regelméisseg	ʀeːʑəlmɜɪsəɕ
regierung	ʀeʑiːʀuŋ
régime	ʀeʒim
réglage	ʀeglaːʃ
rei	ʀɑɪ
réi	ʀɜɪ
reide	ʀɑɪdə
reiden	ʀɑɪdən
réiere	ʀɜɪəʀə
réieren	ʀɜɪəʀən
reim	ʀɑɪm
reiser	ʀɑɪzɐ
reiwe	ʀɑɪvə
reiwen	ʀɑɪvən
reklam	ʀəklɑm
reklamatioun	ʀəklɑmɑsjəʊn
reklaméiere	ʀəklɑmɜɪəʀə
reklaméieren	ʀəklɑmɜɪəʀən
rekolt	ʀəkolt
remarque	ʀəmɑʀk
remboursement	ʀɑ̃ːmbuʀsmænt
remorque	ʀəmɔʀk
rendezvous	ʀɑ̃ːdeːvuː
rëndfleesch	ʀəntfleːʃ
reng	ʀæŋ
rénk	ʀeŋk
renke	ʀæŋkə
renken	ʀæŋkən
renndéier	ʀændɜɪɐ
renne	ʀænə
rënne	ʀənə
rennen	ʀænən
rënnen	ʀənən
renseignement	ʀɑ̃ːsæɲəmænt
rent	ʀænt
rentabel	ʀæntaːbəl
reparatur	ʀəpɑʀɑtuːʀ
reporter	ʀəpɔʀtɐ
rëpp	ʀəp
rescht	ʀæʃt
rëschte	ʀəʃtə
rëschten	ʀəʃtən
rësel	ʀəzəl
rësele	ʀəzələ
rëselen	ʀəzələn
reserve	ʀezɛʀf
reservéiere	ʀezɛʀvɜɪəʀə
reservéieren	ʀezɛʀvɜɪəʀən
respekt	ʀæspækt
respektiv	ʀæspæktiːf
responsabel	ʀæspɑ̃ːsaːbəl
responsabele	ʀæspɑ̃ːsaːbələ
responsabelen	ʀæspɑ̃ːsaːbələn
rëss	ʀəs
ressort	ʀəsɔːʀ
restaurant	ʀæstoːʀɑ̃ː
resultat	ʀəzultaːt
retour	ʀətuːʀ
rette	ʀætə
retten	ʀætən
rettung	ʀætuŋ
réunioun	ʀeːynjəʊn
revolver	ʀəvolvɐ
revue	ʀəvyː
rezdechaussée	ʀeːtʃoːseː
rezept	ʀətsæpt
rhytmus	ʀitmus
ribb	ʀip
ribbe	ʀibə
ribben	ʀibən
riche	ʀiɕə
richen	ʀiɕən
richteg	ʀiɕtəɕ
rido	ʀidoː
ried	ʀiət
riede	ʀiədə
riedele	ʀiədələ
riedelen	ʀiədələn
rieden	ʀiədən
riedner	ʀiədnɐ
rief	ʀiəf
riets	ʀiəts
riicht	ʀiːɕt
riichtaus	ʀiːʑdæːʊs
riichter	ʀiːɕtɐ
riichteraus	ʀiːʑdəʀæːʊs
riichtewech	ʀiːʑdəvæɕ
rill	ʀil
rimm	ʀim
ris	ʀiːs
riseg	ʀiːzəɕ
risele	ʀizələ
riselen	ʀizələn
riserad	ʀiːzəʀaːt
riskéiere	ʀiskɜɪəʀə
riskéieren	ʀiskɜɪəʀən
roboter	ʀobotɐ
rode	ʀoːdə
roden	ʀoːdən
roff	ʀof
roll	ʀol
rollschong	ʀolʃoŋ
rollstull	ʀolʃtul
rollued	ʀolluət
rolze	ʀoltsə
rolzen	ʀoltsən
roman	ʀomaːn
romantesch	ʀomɑntəʃ
romarin	ʀomɑʀɛ̃ː
rommel	ʀoməl
rondel	ʀondəl
ronderëm	ʀondəʀəm
ronke	ʀoŋkə
ronken	ʀoŋkən
ronn	ʀon
ronschel	ʀonʃəl
ronschele	ʀonʃələ
ronschelen	ʀonʃələn
rosa	ʀoːzaː
rose	ʀoːzə
rosen	ʀoːzən
roserei	ʀozəʀɑɪ
rot	ʀoːt
rou	ʀəʊ
roudelzeg	ʀəʊdəltsəɕ
roue	ʀəʊə
roueg	ʀəʊəɕ
rouen	ʀəʊən
rouer	ʀəʊɐ
roulad	ʀulaːt
roulade	ʀulaːdə
rouladen	ʀulaːdən
roulotte	ʀulot
rous	ʀəʊs
rouscht	ʀəʊʃt
rouse	ʀəʊzə
rousekranz	ʀəʊzəkʀɑnts
rousen	ʀəʊzən
rout	ʀəʊt
routine	ʀutin
rucksak	ʀukzaːk
rücksicht	ʀykziɕt
rudder	ʀudɐ
rudderboot	ʀudɐboːt
ruddere	ʀudəʀə
rudderen	ʀudəʀən
ruffe	ʀufə
ruffen	ʀufən
rugby	ʀygbiː
ruin	ʀuːiːn
rull	ʀul
rulle	ʀulə
rullen	ʀulən
rumänesch	ʀumɛːnəʃ
rumm	ʀum
rüssel	ʀysəl
russesch	ʀusəʃ
rutschbahn	ʀutʃbaːn
rutsche	ʀutʃə
rutschen	ʀutʃən
rutt	ʀut
saach	zaːχ
saaft	zaːft
sabbelduch	zɑbəlduχ
sabbele	zɑbələ
sabbelen	zɑbələn
sächlech	zæɕləɕ
sachlech	zɑχləɕ
säfteg	zæftəɕ
saier	zɑɪɐ
säin	zæːɪn
saison	sɛːzɑ̃ː
säit	zæːɪt
sak	zaːk
sakgaass	zaːkgaːs
salef	zaːləf
sall	zɑl
sällche	zælɕə
sällchen	zælɕən
salon	sɑlɑ̃ː
salz	zɑlts
salzdëppche	zɑltsdəpɕə
salzdëppchen	zɑltsdəpɕən
salze	zɑltsə
salzeg	zɑltsəɕ
salzen	zɑltsən
sam	zaːm
samett	zaːmæt
sammele	zɑmələ
sammelen	zɑmələn
samschdeg	zɑmʃdəɕ
samschdes	zɑmʃdəs
sand	zɑnt
sandal	zɑndaːl
sandauer	zɑndɑʊɐ
sandbuerg	zɑntbuːɐɕ
sandkëscht	zɑntkəʃt
sandwich	sæntwitʃ
sanéierung	zɑnɜɪəʀuŋ
sange	zɑŋə
sangen	zɑŋən
sänger	zæŋɐ
sängerin	zæŋəʀin
sat	zaːt
sau	zæːʊ
sauer	zɑʊɐ
sauerampel	zɑʊɐɑmpəl
sauerkraut	zɑʊɐkʀɑʊt
sauermous	zɑʊɐməʊs
sauerstoff	zɑʊɐʃtof
saufe	zæːʊfə
saufen	zæːʊfən
sauna	zɑʊnaː
saz	zaːts
schaardeg	ʃaːʀdəɕ
schaarf	ʃaːɐf
schaaschtech	ʃaːʃtəɕ
schach	ʃɑχ
schäerft	ʃɛːɐft
schaf	ʃaːf
schafe	ʃaːfə
schafen	ʃaːfən
schäffche	ʃæfɕə
schäffchen	ʃæfɕən
schaffdag	ʃɑfdaːχ
schäffe	ʃæfə
schaffe	ʃɑfə
schäffen	ʃæfən
schaffen	ʃɑfən
schaffert	ʃɑfɐt
schaime	ʃɑɪmə
schaimen	ʃɑɪmən
schäin	ʃæːɪn
schäissdreck	ʃæːɪsdʀæk
schäisse	ʃæːɪsə
schäissen	ʃæːɪsən
schal	ʃaːl
schale	ʃaːlə
schalen	ʃaːlən
schallekseg	ʃɑleksəɕ
schalter	ʃɑltɐ
schampes	ʃɑmpəs
schan	ʃaːn
schank	ʃɑŋk
schapp	ʃɑp
schappe	ʃɑpə
schappeg	ʃɑpəɕ
schappen	ʃɑpən
schatz	ʃɑts
schätze	ʃætsə
schätzen	ʃætsən
schätzung	ʃætsuŋ
schauer	ʃɑʊɐ
schauere	ʃɑʊəʀə
schaueren	ʃɑʊəʀən
schaukel	ʃɑʊkəl
schaukele	ʃɑʊkələ
schaukelen	ʃɑʊkələn
schaukelpäerd	ʃɑʊkəlpɛːɐt
schaum	ʃæːʊm
schaumläffel	ʃæːʊmlæfəl
schauspiller	ʃɑʊʃpilɐ
schauspillerin	ʃɑʊʃpiləʀin
schausseg	ʃæːʊsəɕ
scheck	ʃæk
scheckbuch	ʃækbuχ
schécke	ʃekə
schécken	ʃekən
schëdde	ʃədə
schëdden	ʃədən
scheede	ʃeːdə
scheeden	ʃeːdən
scheedung	ʃeːduŋ
schëff	ʃəf
schei	ʃɑɪ
scheier	ʃɑɪɐ
schéier	ʃɜɪɐ
schéifer	ʃɜɪfɐ
schéin	ʃɜɪn
schéinheet	ʃɜɪnheːt
scheinwerfer	ʃɑɪnvɛʀfɐ
schéissbud	ʃɜɪsbuːt
schéisse	ʃɜɪsə
schéissen	ʃɜɪsən
schëld	ʃəlt
schell	ʃæl
schelle	ʃælə
schellen	ʃælən
schëller	ʃəlɐ
schénge	ʃeŋə
schéngen	ʃeŋən
schenke	ʃæŋkə
schenken	ʃæŋkən
schëpp	ʃəp
schëppche	ʃəpɕə
schëppchen	ʃəpɕən
schi	ʃiː
schibengel	ʃiːbæŋəl
schick	ʃik
schicksal	ʃikzaːl
schiedlech	ʃiədləɕ
schiele	ʃiələ
schielen	ʃiələn
schierbel	ʃiːɐbəl
schierbele	ʃiːɐbələ
schierbelen	ʃiːɐbələn
schiertech	ʃiːɐtəɕ
schiet	ʃiət
schif	ʃiːf
schifer	ʃiːfɐ
schildkröt	ʃiltkʀøːt
schimmeg	ʃiməɕ
schimmeleg	ʃimələɕ
schimt	ʃimt
schinn	ʃin
schippelche	ʃipəlɕə
schippelchen	ʃipəlɕən
schlaang	ʃlaːŋ
schlagsahn	ʃlaːχsaːn
schläiche	ʃlæːɪɕə
schläichen	ʃlæːɪɕən
schläife	ʃlæːɪfə
schläifen	ʃlæːɪfən
schlaksert	ʃlɑksɐt
schlamm	ʃlɑm
schlank	ʃlɑŋk
schlapp	ʃlɑp
schlass	ʃlɑs
schlässer	ʃlæsɐ
schlau	ʃlɑʊ
schlauch	ʃlæːʊχ
schlecht	ʃlæɕt
schléck	ʃlek
schlécke	ʃlekə
schlécken	ʃlekən
schleefe	ʃleːfə
schleefen	ʃleːfən
schleek	ʃleːk
schleekenhaische	ʃleːkənhɑɪsjə
schleekenhaischen	ʃleːkənhɑɪsjən
schleidere	ʃlɑɪdəʀə
schleideren	ʃlɑɪdəʀən
schleier	ʃlɑɪɐ
schléif	ʃlɜɪf
schléifer	ʃlɜɪfɐ
schleis	ʃlɑɪs
schléiwe	ʃlɜɪvə
schléiwen	ʃlɜɪvən
schléiwenheck	ʃlɜɪvənhæk
schlëmm	ʃləm
schlëssel	ʃləsəl
schlësselbee	ʃləsəlbeː
schlësselbeen	ʃləsəlbeːn
schlëssellach	ʃləsəllɑχ
schliisslech	ʃliːsləɕ
schlips	ʃlips
schlitt	ʃlit
schlittschong	ʃlitʃoŋ
schlitz	ʃlits
schloe	ʃloːə
schloen	ʃloːən
schlof	ʃloːf
schlofe	ʃloːfə
schlofen	ʃloːfən
schloff	ʃlof
schlofkap	ʃloːfkaːp
schlofkummer	ʃloːfkumɐ
schlofsak	ʃloːfzaːk
schlofzëmmer	ʃloːftsəmɐ
schloper	ʃloːpɐ
schloree	ʃloːʀeː
schloreen	ʃloːʀeːn
schluecht	ʃluəɕt
schluechte	ʃluəɕtə
schluechten	ʃluəɕtən
schluechthaus	ʃluəɕthæːʊs
schluet	ʃluət
schlupp	ʃlup
schluppe	ʃlupə
schluppen	ʃlupən
schluss	ʃlus
schmaache	ʃmaːχə
schmaachen	ʃmaːχən
schmalz	ʃmɑlts
schmeier	ʃmɑɪɐ
schmëlze	ʃməltsə
schmëlzen	ʃməltsən
schmier	ʃmiːɐ
schmiere	ʃmiːɐʀə
schmieren	ʃmiːɐʀən
schmotzeg	ʃmotsəɕ
schmuddeleg	ʃmudələɕ
schmuel	ʃmuəl
schmuelef	ʃmuələf
schmull	ʃmul
schmunze	ʃmuntsə
schmunzen	ʃmuntsən
schnaarche	ʃnaːʀɕə
schnaarchen	ʃnaːʀɕən
schnäize	ʃnæːɪtsə
schnäizen	ʃnæːɪtsən
schnape	ʃnaːpə
schnapen	ʃnaːpən
schnapp	ʃnɑp
schnaps	ʃnɑps
schnatt	ʃnɑt
schnauer	ʃnɑʊɐ
schnauz	ʃnæːʊts
schneekeg	ʃneːkəɕ
schnéi	ʃnɜɪ
schnéibiesem	ʃnɜɪbiəzəm
schneide	ʃnɑɪdə
schneiden	ʃnɑɪdən
schneider	ʃnɑɪdɐ
schneie	ʃnɑɪə
schneien	ʃnɑɪən
schnéiflack	ʃnɜɪflɑk
schnéiklatz	ʃnɜɪklɑts
schnéimännche	ʃnɜɪmænɕə
schnéimännchen	ʃnɜɪmænɕən
schnéiwick	ʃnɜɪvik
schnell	ʃnæl
schnëppel	ʃnəpəl
schnëss	ʃnəʃ
schnësse	ʃnəsə
schnëssen	ʃnəsən
schnëtze	ʃnətsə
schnëtzen	ʃnətsən
schniewel	ʃniəvəl
schnitzel	ʃnitsəl
schnoffele	ʃnofələ
schnoffelen	ʃnofələn
schnouer	ʃnəʊɐ
schnuddel	ʃnudəl
schnuddelhong	ʃnudəlhoŋ
schnurres	ʃnuʀəs
scho	ʃo
schock	ʃok
schockela	ʃokəlaː
schof	ʃoːf
schokant	ʃokɑnt
schold	ʃolt
schong	ʃoŋ
schonggréisst	ʃoŋgʀɜɪst
schongläffel	ʃoŋlæfəl
schongnummer	ʃoŋnumɐ
schongstréckel	ʃoŋʃtʀekəl
schonn	ʃon
schossel	ʃosəl
schoul	ʃəʊl
schoulmeeschter	ʃəʊlmeːʃtɐ
schoulsak	ʃəʊlzaːk
schoune	ʃəʊnə
schounen	ʃəʊnən
schouschter	ʃəʊʃtɐ
schräiner	ʃʀæːɪnɐ
schratt	ʃʀɑt
schrauf	ʃʀɑʊf
schraufstack	ʃʀɑʊfʃtɑk
schrauwe	ʃʀɑʊvə
schrauwemudder	ʃʀɑʊvəmudɐ
schrauwen	ʃʀɑʊvən
schrauwenzéier	ʃʀɑʊvəntsɜɪɐ
schreck	ʃʀæk
schrécke	ʃʀekə
schrécken	ʃʀekən
schrecklech	ʃʀækləɕ
schrëft	ʃʀəft
schrëftlech	ʃʀəftləɕ
schrëftsteller	ʃʀəftʃtælɐ
schreifdësch	ʃʀɑɪfdəʃ
schreifmaschinn	ʃʀɑɪfmɑʃin
schréips	ʃʀɜɪps
schréipse	ʃʀɜɪpsə
schréipsen	ʃʀɜɪpsən
schreiwe	ʃʀɑɪvə
schreiwen	ʃʀɑɪvən
schro	ʃʀoː
schrott	ʃʀot
schrubbe	ʃʀubə
schrubben	ʃʀubən
schrubber	ʃʀubɐ
schrumm	ʃʀum
schubkar	ʃubkaːʀ
schudder	ʃudɐ
schuddere	ʃudəʀə
schudderen	ʃudəʀən
schueberfouer	ʃuəbɐfəʊɐ
schued	ʃuət
schuede	ʃuədə
schueden	ʃuədən
schuel	ʃuəl
schüler	ʃyːlɐ
schülerin	ʃyːləʀin
schumme	ʃumə
schummen	ʃumən
schupp	ʃup
schutzblech	ʃutsblæɕ
schütze	ʃytsə
schützen	ʃytsən
schwaach	ʃwaːχ
schwaachheet	ʃwaːχheːt
schwaarz	ʃwaːʀts
schwäche	ʃwæɕə
schwächen	ʃwæɕən
schwächt	ʃwæɕt
schwäerme	ʃwɛːɐmə
schwäermen	ʃwɛːɐmən
schwäin	ʃwæːɪn
schwäistall	ʃwæːɪʃtɑl
schwäiz	ʃwæːɪts
schwammbox	ʃwɑmboks
schwamme	ʃwɑmə
schwammen	ʃwɑmən
schwamp	ʃwɑmp
schwan	ʃwaːn
schwanz	ʃwɑnts
schwätze	ʃwætsə
schwätzen	ʃwætsən
schwedesch	ʃweːdəʃ
schweess	ʃweːs
schweesse	ʃweːsə
schweessen	ʃweːsən
schwéier	ʃwɜɪɐ
schwéiereltere	ʃwɜɪɐæltəʀə
schwéierelteren	ʃwɜɪɐæltəʀən
schwéierleit	ʃwɜɪɐlɑɪt
schwéiermamm	ʃwɜɪɐmɑm
schwéierpapp	ʃwɜɪɐpɑp
schwéiesch	ʃwɜɪəʃ
schwëlle	ʃwələ
schwëllen	ʃwələn
schwemm	ʃwæm
schwëmmer	ʃwəmɐ
schwéngefleesch	ʃweŋəfleːʃ
schwéngerei	ʃweŋəʀɑɪ
schwéngskotlett	ʃweŋskotlæt
schwenke	ʃwæŋkə
schwenken	ʃwæŋkən
schwëster	ʃwəstɐ
schwier	ʃwiːɐ
schwiere	ʃwiːɐʀə
schwiereg	ʃwiːʀəɕ
schwieregkeet	ʃwiːʀəɕkeːt
schwieren	ʃwiːɐʀən
schwiewe	ʃwiəvə
schwiewen	ʃwiəvən
schwoer	ʃwoːɐ
schwonk	ʃwoŋk
scout	skɑʊt
se	zə
sech	zəɕ
séchel	zəɕəl
sécher	zəɕɐ
sécherheet	zəɕɐheːt
sécherheetsglas	zəɕɐheːtsglaːs
sécherheetsnetz	zəɕɐheːtsnæts
sécherheetsrimm	zəɕɐheːtsʀim
sechs	zæks
sechsavéierzeg	zæksɑfɜɪɐtsəɕ
sechsdausend	zæksdɑʊzənt
sechste	zækstə
sechsten	zækstən
sechzeg	zæɕtsəɕ
séckche	zekɕə
séckchen	zekɕən
see	zeː
seeche	zeːɕə
seechen	zeːɕən
seechomes	zeːʑoːməs
seeën	zeːən
seef	zeːf
seefe	zeːfə
seefen	zeːfən
seefepolver	zeːfəpolfɐ
seel	zeːl
seeldänzer	zeːldæntsɐ
seele	zeːlə
seelen	zeːlən
seelsprange	zeːlʃpʀɑŋə
seelsprangen	zeːlʃpʀɑŋən
seemiel	zeːmiəl
seen	zeːn
seene	zeːnə
seenen	zeːnən
sëff	zəf
sëffer	zəfɐ
segel	zeːʑəl
segelboot	zeːʑəlboːt
segele	zeːʑələ
segelen	zeːʑələn
seguer	zəguːɐ
séi	zɜɪ
seibecke	zɑɪbækə
seibecken	zɑɪbækən
seid	zɑɪt
séie	zɜɪə
séien	zɜɪən
séier	zɜɪɐ
séihond	zɜɪhont
séikrank	zɜɪkʀɑŋk
séil	zɜɪl
séiss	zɜɪs
séiwaasser	zɜɪvaːsɐ
sekonn	zəkon
sekretär	səkʀetɛːʀ
sekretariat	səkʀetɑʀjaːt
sekretärin	səkʀetɛːʀin
sëllech	zələɕ
selwer	zælvɐ
sëlwer	zəlvɐ
sëndege	zəndəʑə
sëndegen	zəndəʑən
seng	zeŋ
sënn	zən
september	zæptembɐ
serie	seʀiː
serjö	sæʀjøː
serveuse	sɛʀvøːs
service	sɛʀvis
servicer	sɛʀvisɐ
sëtz	zəts
setze	zætsə
sëtze	zətsə
setzen	zætsən
sëtzen	zətsən
sëtzung	zətsuŋ
seufze	zoɪftsə
seufzen	zoɪftsən
short	ʃɔʀt
si	ziː
siche	ziɕə
sichen	ziɕən
sickere	zikəʀə
sickeren	zikəʀən
siechzeg	ziəɕtsəɕ
siechzéng	ziəɕtseŋ
sief	ziəf
siff	zif
siffe	zifə
siffen	zifən
sinistréiert	sinistʀɜɪɐt
sinn	zin
sireen	siʀeːn
sirup	siʀup
siwe	ziːvə
siwen	ziːvən
siwente	ziːvəntə
siwenten	ziːvəntən
siweschléifer	ziːvəʃlɜɪfɐ
siwwenzeg	zivəntsəɕ
siwwenzéng	zivəntseŋ
skizz	skits
soe	zoːə
soen	zoːən
solde	soldə
solden	soldən
solle	zolə
sollen	zolən
som	zoːm
sonn	zon
sonndeg	zondəɕ
sonndes	zondəs
sonneg	zonəɕ
sonneprabbeli	zonəpʀɑbəliː
sonnestéch	zonəʃtəɕ
soss	zos
sou	zəʊ
soubal	zəʊbaːl
sougenannt	zəʊgənɑnt
souguer	zəʊguːɐ
soutien	sutjɛ̃ː
souvill	zəʊfil
souwisou	zəʊvizəʊ
spaass	ʃpaːs
spaasse	ʃpaːsə
spaasseg	ʃpaːsəɕ
spaassen	ʃpaːsən
spachtel	ʃpɑχtəl
spackelter	ʃpɑkəltɐ
spadséiere	ʃpɑdzɜɪəʀə
spadséieren	ʃpɑdzɜɪəʀən
spadséiergank	ʃpɑdzɜɪɐgɑŋk
spaghetti	ʃpɑgætiː
späicher	ʃpæːɪɕɐ
späize	ʃpæːɪtsə
späizen	ʃpæːɪtsən
spane	ʃpaːnə
spanen	ʃpaːnən
spann	ʃpɑn
spanne	ʃpɑnə
spannen	ʃpɑnən
spannend	ʃpɑnənt
spannung	ʃpɑnuŋ
späre	ʃpɛːʀə
spären	ʃpɛːʀən
spargel	ʃpɑʀʑəl
spatz	ʃpɑts
spaut	ʃpæːʊt
spaweck	ʃpaːvæk
specht	ʃpæɕt
speck	ʃpæk
speis	ʃpɑɪs
spéit	ʃpɜɪt
spéitstens	ʃpɜɪtstəns
spektiv	ʃpæktiːf
spéngel	ʃpeŋəl
spéngele	ʃpeŋələ
spéngelen	ʃpeŋələn
spënnche	ʃpənɕə
spënnchen	ʃpənɕən
spëtzbouf	ʃpətsbəʊf
spëtze	ʃpətsə
spëtzen	ʃpətsən
spëtznumm	ʃpətsnum
spëtzt	ʃpətst
spezialist	ʃpetsjaːlist
spezifesch	ʃpetsiːfəʃ
spidol	ʃpidoːl
spiecht	ʃpiəɕt
spiere	ʃpiːʀə
spieren	ʃpiːʀən
spigel	ʃpiʑəl
spigelee	ʃpiʑəleː
spill	ʃpil
spillbuttek	ʃpilbutek
spille	ʃpilə
spillen	ʃpilən
spillplaz	ʃpilplaːts
spillsaach	ʃpilzaːχ
spinat	ʃpinaːt
spioun	ʃpjəʊn
spläiter	ʃplæːɪtɐ
spléck	ʃplek
splécke	ʃplekə
splécken	ʃplekən
splitter	ʃplitɐ
sport	ʃpɔʀt
sportlech	ʃpɔʀtləɕ
spottnumm	ʃpotnum
sprangbur	ʃpʀɑŋbuːʀ
sprange	ʃpʀɑŋə
sprangen	ʃpʀɑŋən
sprangseel	ʃpʀɑŋzeːl
sprechzëmmer	ʃpʀæɕtsəmɐ
spréif	ʃpʀɜɪf
sprenz	ʃpʀænts
sprëtz	ʃpʀəts
sprëtze	ʃpʀətsə
sprëtzen	ʃpʀətsən
sprinkler	ʃpʀiŋklɐ
sprock	ʃpʀok
spronk	ʃpʀoŋk
sprooch	ʃpʀoːχ
spruddele	ʃpʀudələ
spruddeleg	ʃpʀudələɕ
spruddelen	ʃpʀudələn
spruddelwaasser	ʃpʀudəlvaːsɐ
sprutze	ʃpʀutsə
sprutzen	ʃpʀutsən
spuenesch	ʃpuənəʃ
spuenie	ʃpuəniə
spuenien	ʃpuəniən
spuerbéchs	ʃpuːɐbeks
spuere	ʃpuːɐʀə
spueren	ʃpuːɐʀən
spuerkeess	ʃpuːɐkeːs
spuervull	ʃpuːɐful
spuet	ʃpuət
spull	ʃpul
spulle	ʃpulə
spullen	ʃpulən
spullmaschinn	ʃpulmɑʃin
spullomp	ʃpullomp
spullstee	ʃpulʃtee
spullsteen	ʃpulʃteen
spur	ʃpuːʀ
sputt	ʃput
staang	ʃtaːŋ
staark	ʃtaːʀk
staatsrot	ʃtaːtsʀoːt
stäbercher	ʃtɛːbɐɕɐ
stabill	ʃtɑbil
stachel	ʃtɑχəl
stack	ʃtɑk
stackfësch	ʃtɑkfəʃ
stad	ʃtaːt
stage	staːʃ
stäil	ʃtæːɪl
stäip	ʃtæːɪp
stäipe	ʃtæːɪpə
stäipen	ʃtæːɪpən
stall	ʃtɑl
stallhale	ʃtɑlhaːlə
stallhalen	ʃtɑlhaːlən
stamm	ʃtɑm
standard	stɑ̃ːndaːʀ
stär	ʃtɛːɐ
starte	ʃtaːʀtə
starten	ʃtaːʀtən
starter	ʃtaːʀtɐ
stat	ʃtaːt
statu	ʃtaːtuː
stau	ʃtɑʊ
staubsauger	ʃtæːʊbzɑʊgɐ
staumauer	ʃtɑʊmɑʊɐ
staune	ʃtɑʊnə
staunen	ʃtɑʊnən
stauséi	ʃtɑʊzɜɪ
staut	ʃtæːʊt
stëbs	ʃtəps
stëbse	ʃtəpsə
stëbsen	ʃtəpsən
stëbsfatz	ʃtəpsfɑts
stëbslomp	ʃtəpslomp
stéck	ʃtek
steckdous	ʃtækdəʊs
stecker	ʃtækɐ
stéckseg	ʃteksəɕ
stee	ʃteː
steekaul	ʃteːkɑʊl
steemetzer	ʃteːmætsɐ
steen	ʃteːn
steier	ʃtɑɪɐ
stéier	ʃtɜɪɐ
stéiere	ʃtɜɪəʀə
stéieren	ʃtɜɪəʀən
steif	ʃtɑɪf
stéifkand	ʃtɜɪfkɑnt
stéifmamm	ʃtɜɪfmɑm
stéifpapp	ʃtɜɪfpɑp
steiwe	ʃtɑɪvə
steiwen	ʃtɑɪvən
stëll	ʃtəl
stelle	ʃtælə
stellen	ʃtælən
stelz	ʃtælts
stëmm	ʃtəm
stëmme	ʃtəmə
stëmmen	ʃtəmən
stëmmung	ʃtəmuŋ
stempel	ʃtæmpəl
stempele	ʃtæmpələ
stempelen	ʃtæmpələn
stenge	ʃtæŋə
stengen	ʃtæŋən
sténke	ʃteŋkə
sténken	ʃteŋkən
stënterlech	ʃtəntɐləɕ
stëppche	ʃtəpɕə
stëppchen	ʃtəpɕən
steppe	ʃtæpə
stëppele	ʃtəpələ
stëppelen	ʃtəpələn
steppen	ʃtæpən
steriliséiere	ʃteʀilizɜɪəʀə
steriliséieren	ʃteʀilizɜɪəʀən
stiedche	ʃtiətɕə
stiedchen	ʃtiətɕən
stiele	ʃtiələ
stielen	ʃtiələn
stierme	ʃtiːɐmə
stiermen	ʃtiːɐmən
stierwe	ʃtiːɐvə
stierwen	ʃtiːɐvən
stierze	ʃtiːɐtsə
stierzen	ʃtiːɐtsən
stiichte	ʃtiːɕtə
stiichten	ʃtiːɕtən
still	ʃtil
stitzche	ʃtitsjə
stitzchen	ʃtitsjən
stiwwel	ʃtivəl
stodéiere	ʃtodɜɪəʀə
stodéieren	ʃtodɜɪəʀən
stodent	ʃtodænt
stoe	ʃtoːə
stoen	ʃtoːən
stoff	ʃtof
stol	ʃtoːl
stolpere	ʃtolpəʀə
stolperen	ʃtolpəʀən
stomm	ʃtom
stompeg	ʃtompəɕ
stonn	ʃton
stonnelaang	ʃtonəlaːŋ
stop	ʃtop
stopp	ʃtop
stoppe	ʃtopə
stoppen	ʃtopən
stoppenzéier	ʃtopəntsɜɪɐ
stopschëld	ʃtopʃəlt
storch	ʃtɔʀɕ
store	stɔːʀ
stot	ʃtoːt
stousse	ʃtəʊsə
stoussen	ʃtəʊsən
sträiche	ʃtʀæːɪɕə
sträichen	ʃtʀæːɪɕən
sträif	ʃtʀæːɪf
sträit	ʃtʀæːɪt
stral	ʃtʀaːl
strapp	ʃtʀɑp
strass	ʃtʀɑs
strauch	ʃtʀæːʊχ
strauss	ʃtʀæːʊs
stréch	ʃtʀəɕ
streckbriet	ʃtʀækbʀiət
strecke	ʃtʀækə
strécke	ʃtʀekə
stréckel	ʃtʀekəl
strecken	ʃtʀækən
strécken	ʃtʀekən
stréckleeder	ʃtʀekleːdɐ
streech	ʃtʀeːɕ
streeën	ʃtʀeən
stréi	ʃtʀɜɪ
stréiballe	ʃtʀɜɪbɑlə
stréiballen	ʃtʀɜɪbɑlən
streide	ʃtʀɑɪdə
streiden	ʃtʀɑɪdən
streidereg	ʃtʀɑɪdəʀəɕ
stréihutt	ʃtʀɜɪhut
streik	ʃtʀɑɪk
stréile	ʃtʀɜɪlə
stréilen	ʃtʀɜɪlən
strëmp	ʃtʀəmp
streng	ʃtʀæŋ
strenz	ʃtʀænts
strof	ʃtʀoːf
strofe	ʃtʀoːfə
strofen	ʃtʀoːfən
strooss	ʃtʀoːs
stroossekaart	ʃtʀoːsəkaːʀt
stroosseluucht	ʃtʀoːsəluːχt
stroosseschëld	ʃtʀoːsəʃəlt
stroum	ʃtʀəʊm
strummert	ʃtʀumɐt
stuckele	ʃtukələ
stuckelen	ʃtukələn
studéiere	ʃtudɜɪəʀə
studéieren	ʃtudɜɪəʀən
student	ʃtudænt
stuerke	ʃtuːɐkə
stuerken	ʃtuːɐkən
stuerm	ʃtuːɐm
stuff	ʃtuf
stull	ʃtul
stulldreiwend	ʃtuldʀɑɪvənt
stur	ʃtuːʀ
stylo	stiloː
succès	syksɛː
suckel	zukəl
suckele	zukələ
suckelen	zukələn
süde	zyːdə
süden	zyːdən
sue	zuːə
suedel	zuədəl
suel	zuəl
suen	zuən
suerg	zuːɐɕ
suerge	zuːɐʑə
suergen	zuːɐʑən
suggeréiere	sygʒeʀɜɪəʀə
suggeréieren	sygʒeʀɜɪəʀən
sujet	syʒeː
sujete	syʒeːə
summer	zumɐ
summerwee	zumɐweː
super	zupɐ
supp	zup
suppeg	zupəɕ
suppel	supəl
surfe	sœːʀfə
surfen	sœːʀfən
surveillant	syʀvɛːjɑ̃ː
sympathesch	simpaːtəʃ
taart	taːʀt
taaschte	taːʃtə
taaschten	taːʃtən
tabell	tɑbæl
tableau	tɑbloː
tablette	tɑblæt
tabouret	tɑbuʀeː
tachtele	tɑχtələ
tachtelen	tɑχtələn
tafel	taːfəl
taille	tɑɪl
talent	tɑlənt
tallek	tɑlek
tank	tɑŋk
tanke	tɑŋkə
tanken	tɑŋkən
tankwon	tɑŋkvoːn
tapéit	tɑpɜɪt
tarnung	tɑʀnuŋ
tas	taːs
täsch	tæʃ
täscheluucht	tæʃəluːχt
täschemesser	tæʃəmæsɐ
tässele	tæsələ
tässelen	tæsələn
tatsächlech	taːtzæɕləɕ
tatta	tɑtaː
tatz	tɑts
taucher	tæːʊχɐ
tausche	tæːʊʃə
tauschen	tæːʊʃən
taxi	tɑksiː
techniker	tæɕnikɐ
técke	tekə
técken	tekən
teenager	tiːnɜɪdʒɐ
téi	tɜɪ
téitsch	tɜɪtʃ
tëlee	təleː
telefon	tələfon
telefonéiere	tələfonɜɪəʀə
telefonéieren	tələfonɜɪəʀən
telefonsbuch	tələfonsbuχ
telefonsnummer	tələfonsnumɐ
telegramm	tələgʀɑm
teleskop	telæskoːp
televisioun	tələvizjəʊn
teller	tælɐ
tellerche	tælɐɕə
tellerchen	tælɐɕən
tëmpche	təmpɕə
tëmpchen	təmpɕən
temperatur	tæmpəʀɑtuːʀ
tendenz	tændænts
tennis	tænis
tënt	tənt
teppech	tæpəɕ
termäin	tɛʀmæːɪn
terrain	tæʀɛ̃ː
terrass	tæʀɑs
tëschent	təʃənt
tëschewand	təʃəvɑnt
text	tækst
theater	teaːtɐ
thermometer	tɛʀmomeːtɐ
thon	tɑ̃ː
thüringer	tyʀiŋɐ
ticket	tikeː
ticketsautomat	tikeːzɑʊtomaːt
tierkele	tiːɐkələ
tierkelen	tiːɐkələn
tiger	tiːgɐ
timber	tɛ̃ːbɐ
tipp	tip
tippe	tipə
tippen	tipən
tiptop	tiptop
tirang	tiʀɑŋ
tirebouchon	tiːɐbuʃɑ̃ː
titel	titəl
toast	təʊst
toaster	təʊstɐ
tobe	toːbə
toben	toːbən
toilette	twɑlæt
toilettepabeier	twɑlætəpɑbɑɪɐ
toleréiere	toləʀɜɪəʀə
toleréieren	toləʀɜɪəʀən
tomat	tomaːt
tomatejus	tomaːtəjyː
tombola	tomboːlaː
tommel	toməl
tommele	tomələ
tommelen	tomələn
tompe	tompə
tompen	tompən
topeg	toːpəɕ
topert	toːpɐt
torschong	tɔʀʃoŋ
tosch	toʃ
toun	təʊn
tour	tuːʀ
tourist	tuʀist
tous	tus
toz	toːts
toze	toːtsə
tozen	toːtsən
traditionell	tʀɑditsjonæl
training	tʀɛːniŋ
träip	tʀæːɪp
träipe	tʀæːɪpə
träipen	tʀæːɪpən
trakter	tʀɑktɐ
tram	tʀɑm
trampele	tʀɑmpələ
trampelen	tʀɑmpələn
träntele	tʀæntələ
träntelen	tʀæntələn
trap	tʀaːp
trapez	tʀɑpeːts
trapp	tʀɑp
tratt	tʀɑt
traue	tʀɑʊə
trauen	tʀɑʊən
trauer	tʀɑʊɐ
trauerweid	tʀɑʊɐvɑɪt
traufel	tʀæːʊfəl
traureg	tʀɑʊʀəɕ
trausch	tʀæːʊʃ
treffe	tʀæfə
treffen	tʀæfən
trei	tʀɑɪ
treiheet	tʀɑɪheːt
tréin	tʀɜɪn
tréischte	tʀɜɪʃtə
tréischten	tʀɜɪʃtən
trëlle	tʀələ
trëllen	tʀələn
trëndel	tʀəndəl
trenne	tʀænə
trennen	tʀænən
trennung	tʀænuŋ
trëppele	tʀəpələ
trëppelen	tʀəpələn
trepplek	tʀæplek
trëttbriet	tʀətbʀiət
trëtz	tʀəts
trëtze	tʀətsə
trëtzen	tʀətsən
trick	tʀik
triichter	tʀiːɕtɐ
tripsen	tʀipsən
triwwele	tʀivələ
triwwelen	tʀivələn
tromm	tʀom
trommelfell	tʀoməlfæl
trompett	tʀompæt
troter	tʀoːtɐ
trottinette	tʀotinæt
trottoir	tʀotwaːʀ
trottoiren	tʀotwaːʀən
trotz	tʀots
trotzdem	tʀotsdeːm
trotze	tʀotsə
trotzeg	tʀotsəɕ
trotzen	tʀotsən
troun	tʀəʊn
trouscht	tʀəʊʃt
truh	tʀuː
trupp	tʀup
tsunami	tsunaːmiː
tubak	tubaːk
tuddele	tudələ
tuddelen	tudələn
tuerm	tuːɐm
tulp	tulp
tunnel	tunæl
tuppi	tupiː
turbot	tyʀboː
turne	tuʀnə
turnen	tuʀnən
turner	tuʀnɐ
turnschlapp	tuʀnʃlɑp
tuschbic	tuʃbik
tut	tuːt
tute	tuːtə
tuten	tuːtən
typ	tip
ubanne	ubɑnə
ubannen	ubɑnən
übe	yːbə
üben	yːbən
ubezuele	ubətsuələ
ubezuelen	ubətsuələn
ubidde	ubidə
ubidden	ubidən
ubiede	ubiədə
ubieden	ubiədən
uboot	uːboːt
übung	yːbuŋ
uebst	uəbst
uebstpress	uəbstpʀæs
uechter	uəɕtɐ
uechzeg	uəɕtsəɕ
uechzéng	uəɕtseŋ
uelech	uələɕ
uerdentlech	uɐdəntləɕ
uerdnung	uɐdnuŋ
uerg	uɐɕ
uerteel	uɐteːl
uertschaft	uɐtʃɑft
uess	uəs
ueter	uətɐ
uewe	uəvə
uewen	uəvən
uewenop	uəvənop
ufänger	ufæŋɐ
ufank	ufɑŋk
ufänke	ufæŋkə
ufänken	ufæŋkən
ufer	uːfɐ
ufuere	ufuːɐʀə
ufueren	ufuːɐʀən
ugeklote	ugəkloːtə
ugekloten	ugəkloːtən
ugesi	ugəzi
ugesinn	ugəzin
ugi	ugi
uginn	ugin
uglotze	uglotsə
uglotzen	uglotsən
ugoe	ugoːə
ugoen	ugoːən
ugräife	ugʀæːɪfə
ugräifen	ugʀæːɪfən
ugrëff	ugʀəf
ugrëffeg	ugʀəfəɕ
ugrëffer	ugʀəfɐ
ukënnege	ukənəʑə
ukënnegen	ukənəʑən
uklo	ukloː
ukloe	ukloːə
ukloen	ukloːən
ukomme	ukomə
ukommen	ukomən
ukräize	ukʀæːɪtsə
ukräizen	ukʀæːɪtsən
ulackele	ulɑkələ
ulackelen	ulɑkələn
uleeën	uleːən
ulm	ulm
um	um
umeldung	umælduŋ
umelle	umælə
umellen	umælən
umoosse	umoːsə
umoossen	umoːsən
undoe	undoːə
undoen	undoːən
undrécke	undʀekə
undrécken	undʀekən
unerkenne	unɐkænə
unerkennen	unɐkænən
unhale	unhaːlə
unhalen	unhaːlən
unhaltspunkt	unhɑltspuŋkt
unhänger	unhæŋɐ
unhänglech	unhæŋləɕ
unhänglechkeet	unhæŋləɕkeːt
unhänke	unhæŋkə
unhänken	unhæŋkən
unhu	unhu
unhuele	unhuələ
unhuelen	unhuələn
unhunn	unhun
uniform	unifɔʀm
upake	upaːkə
upaken	upaːkən
upasse	upɑsə
upassen	upɑsən
upassung	upɑsuŋ
uplanze	uplɑntsə
uplanzen	uplɑntsən
ureege	uʀeːʑə
ureegen	uʀeːʑən
uriede	uʀiədə
urieden	uʀiədən
urmënsch	uːʀmənʃ
ursaach	uːʀzaːχ
ursprénglech	uːʀʃpʀeŋləɕ
uruffe	uʀufə
uruffen	uʀufən
uschäin	uʃæːɪn
uschäisse	uʃæːɪsə
uschäissen	uʃæːɪsən
uschmiere	uʃmiːɐə
uschmieren	uʃmiːʀən
usoe	uzoːə
usoen	uzoːən
ustieche	uʃtiəɕə
ustiechen	uʃtiəɕən
ustiechend	uʃtiəɕənt
ustiwwele	uʃtivələ
ustiwwelen	uʃtivələn
ustrach	uʃtʀɑχ
usträiche	uʃtʀæːɪɕə
usträichen	uʃtʀæːɪɕən
usträicher	uʃtʀæːɪɕɐ
ustrécke	uʃtʀekə
ustrécken	uʃtʀekən
ustrengung	uʃtʀæŋuŋ
uvertraue	ufɐtʀɑʊə
uvertrauen	ufɐtʀɑʊən
uweise	uvɑɪzə
uweisen	uvɑɪzən
uweisung	uvɑɪzuŋ
uze	uːtsə
uzen	uːtsən
vag	vaːk
vakanz	vɑkɑnts
vas	vaːs
vasen	vaːzən
vee	veː
veen	veːn
véi	fɜɪ
véier	fɜɪɐ
véiereck	fɜɪɐæk
véiereckeg	fɜɪɐækəɕ
véierel	fɜɪəʀəl
véierelsstonn	fɜɪəʀəlsʃton
véierte	fɜɪɐtə
véierten	fɜɪɐtən
véierzeg	fɜɪɐtsəɕ
véierzéng	fɜɪɐtseŋ
vëlleche	fələɕə
vëllechen	fələɕən
vëlleg	fələɕ
vëlo	vəloː
vëlosartist	vəloːzɑʀtist
vëlosfuerer	vəloːsfuːɐʀɐ
vëlossport	vəloːsʃpɔʀt
vendeur	vɑ̃ːndœːʀ
vendeuse	vɑ̃ːndøːs
ventouse	vɑ̃ːtuːs
veräin	fəʀæːɪn
verännere	fɐænəʀə
veränneren	fɐænəʀən
verännerung	fɐænəʀuŋ
veräschtelung	fɐæʃtəluŋ
verb	vɛʀp
verband	fɐbɑnt
verbanne	fɐbɑnə
verbannen	fɐbɑnən
verbattert	fɐbɑtɐt
verbéie	fɐbɜɪə
verbéien	fɐbɜɪən
verbessere	fɐbæsəʀə
verbesseren	fɐbæsəʀən
verbëtze	fɐbətsə
verbëtzen	fɐbətsən
verbidde	fɐbidə
verbidden	fɐbidən
verbindung	fɐbinduŋ
verblatze	fɐblɑtsə
verblatzen	fɐblɑtsən
verbléie	fɐblɜɪə
verbléien	fɐblɜɪən
verblenne	fɐblænə
verblennen	fɐblænən
verblöde	fɐbløːdə
verblöden	fɐbløːdən
verbrauch	fɐbʀæːʊχ
verbrauche	fɐbʀæːʊχə
verbrauchen	fɐbʀæːʊχən
verbraucher	fɐbʀæːʊχɐ
verbraucht	fɐbʀæːʊχt
verbreede	fɐbʀeːdə
verbreeden	fɐbʀeːdən
verbrénge	fɐbʀeŋə
verbréngen	fɐbʀeŋən
verbrenne	fɐbʀænə
verbrennen	fɐbʀænən
verbrieche	fɐbʀiəɕə
verbriechen	fɐbʀiəɕən
verbriecher	fɐbʀiəɕɐ
verbuede	fɐbuədə
verbueden	fɐbuədən
verdacht	fɐdɑχt
verdächteg	fɐdæɕtəɕ
verdächtege	fɐdæɕtəʑə
verdächtegen	fɐdæɕtəʑən
verdaddert	fɐdɑdɐt
verdame	fɐdaːmə
verdamen	fɐdaːmən
verdaue	fɐdɑʊə
verdauen	fɐdɑʊən
verdauung	fɐdɑʊuŋ
verdeedege	fɐdeːdəʑə
verdeedegen	fɐdeːdəʑən
verdeele	fɐdeːlə
verdeelen	fɐdeːlən
verdénge	fɐdeŋə
verdéngen	fɐdeŋən
verdéngscht	fɐdeŋʃt
verdënne	fɐdənə
verdënnen	fɐdənən
verdillege	fɐdiləʑə
verdillegen	fɐdiləʑən
verdonste	fɐdonstə
verdonsten	fɐdonstən
verdreckst	fɐdʀækst
verdréie	fɐdʀɜɪə
verdréien	fɐdʀɜɪən
verdreiwe	fɐdʀɑɪvə
verdreiwen	fɐdʀɑɪvən
verdroe	fɐdʀoːə
verdroen	fɐdʀoːən
verdross	fɐdʀos
verduebele	fɐduəbələ
verduebelen	fɐduəbələn
verdutzt	fɐdutst
vereelzt	fɐeːlst
vereenegt	fəʀeːnəɕt
veréiere	fəʀɜɪəʀə
veréieren	fəʀɜɪəʀən
vereinfache	fəʀɑɪnfɑχə
vereinfachen	fəʀɑɪnfɑχən
verfaule	fɐfɑʊlə
verfaulen	fɐfɑʊlən
verfeele	fɐfeːlə
verfeelen	fɐfeːlən
verféiere	fɐfɜɪəʀə
verféieren	fɐfɜɪəʀən
verflucht	fɐfluχt
verfollege	fɐfoləʑə
verfollegen	fɐfoləʑən
verfroosse	fɐfʀoːsə
verfroossen	fɐfʀoːsən
vergaangenheet	fɐgaːŋənheːt
vergewaltege	fɐgəvɑltəʑə
vergewaltegen	fɐgəvɑltəʑən
vergiesse	fɐgiəsə
vergiessen	fɐgiəsən
vergläiche	fɐglæːɪɕə
vergläichen	fɐglæːɪɕən
vergréissere	fɐgʀɜɪsəʀə
vergréisseren	fɐgʀɜɪsəʀən
verhale	fɐhaːlə
verhalen	fɐhaːlən
verhalt	fɐhɑlt
verhandele	fɐhɑndələ
verhandelen	fɐhɑndələn
verheemleche	fɐheːmləɕə
verheemlechen	fɐheːmləɕən
verhéiere	fɐhɜɪəʀə
verhéieren	fɐhɜɪəʀən
verhënnere	fɐhənəʀə
verhënneren	fɐhənəʀən
verhonze	fɐhontsə
verhonzen	fɐhontsən
verkafe	fɐkaːfə
verkafen	fɐkaːfən
verkeefer	fɐkeːfɐ
verkeeferin	fɐkeːfəʀin
verkéier	fɐkɜɪɐ
verkéiersluucht	fɐkɜɪɐsluːχt
verkéiert	fɐkɜɪɐt
verklappe	fɐklɑpə
verklappen	fɐklɑpən
verkleede	fɐkleːdə
verkleeden	fɐkleːdən
verkniwwelt	fɐknivəlt
verkrauche	fɐkʀæːʊχə
verkrauchen	fɐkʀæːʊχən
verkrëppelt	fɐkʀəpəlt
verkuebele	fɐkuəbələ
verkuebelen	fɐkuəbələn
verlaange	fɐlaːŋə
verlaangen	fɐlaːŋən
verlaangere	fɐlaːŋəʀə
verlaangeren	fɐlaːŋəʀən
verlängere	fɐlæŋəʀə
verlängeren	fɐlæŋəʀən
verléiere	fɐlɜɪəʀə
verléieren	fɐlɜɪəʀən
verléift	fɐlɜɪft
verletze	fɐlætsə
verletzen	fɐlætsən
verletzung	fɐlætsuŋ
verlobe	fɐloːbə
verloben	fɐloːbən
verlobung	fɐloːbuŋ
verloosse	fɐloːsə
verloossen	fɐloːsən
verloscht	fɐloʃt
verloune	fɐləʊnə
verlounen	fɐləʊnən
verluge	fɐluʁə
verlugen	fɐluʁən
vermaache	fɐmaːχə
vermaachen	fɐmaːχən
vermësche	fɐməʃə
vermëschen	fɐməʃən
vermuersche	fɐmuːɐʀʃə
vermuerschen	fɐmuːɐʀʃən
vermuuschte	fɐmuːʃtə
vermuuschten	fɐmuːʃtən
vernenne	fɐnænə
vernennen	fɐnænən
vernis	vɛʀniː
vernoléissege	fɐnoːlɜɪsəʑə
vernoléissegen	fɐnoːlɜɪsəʑən
verongléckte	fəʀonglektə
verongléckten	fəʀonglektən
verpackung	fɐpɑkuŋ
verpake	fɐpaːkə
verpaken	fɐpaːkən
verpasse	fɐpɑsə
verpassen	fɐpɑsən
verpolfere	fɐpolfəʀə
verpolferen	fɐpolfəʀən
verréckt	fɐʀekt
verréider	fɐʀɜɪdɐ
verrode	fəʀoːdə
verroden	fəʀoːdən
verrot	fɐʀoːt
vers	vɛʀs
versammele	fɐzɑmələ
versammelen	fɐzɑmələn
versammlung	fɐzɑmluŋ
versaue	fɐzɑʊə
versauen	fɐzɑʊən
verschafe	fɐʃaːfə
verschafen	fɐʃaːfən
verschampeléiere	fɐʃɑmpəlɜɪəʀə
verschampeléieren	fɐʃɑmpəlɜɪəʀən
verschidde	fɐʃidə
verschidden	fɐʃidən
verschimmele	fɐʃimələ
verschimmelen	fɐʃimələn
verschlass	fɐʃlɑs
verschlechtere	fɐʃlæɕtəʀə
verschlechteren	fɐʃlæɕtəʀən
verschlëmmere	fɐʃləməʀə
verschlëmmeren	fɐʃləməʀən
verschmotze	fɐʃmotzə
verschmotzen	fɐʃmotzən
verschotert	fɐʃoːtɐt
verschreiwe	fɐʃʀɑɪvə
verschreiwen	fɐʃʀɑɪvən
verschwanne	fɐʃwɑnə
verschwannen	fɐʃwɑnən
verschweesst	fɐʃweːst
verschwendung	fɐʃwænduŋ
verschwomme	fɐʃwomə
verschwommen	fɐʃwomən
verséchere	fɐzəɕəʀə
versécheren	fɐzəɕəʀən
versécherung	fɐzəɕəʀuŋ
versécherungsspéngel	fɐzəɕəʀuŋsʃpeŋəl
versenge	fɐzæŋə
versengen	fɐzæŋən
versiche	fɐziɕə
versichen	fɐziɕən
versoe	fɐzoːə
versoen	fɐzoːən
verspéide	fɐʃpɜɪdə
verspéiden	fɐʃpɜɪdən
verspéidung	fɐʃpɜɪduŋ
versprieche	fɐʃpʀiəɕə
verspriechen	fɐʃpʀiəɕən
verstäerke	fɐʃtɛːɐkə
verstäerken	fɐʃtɛːɐkən
verstäerkung	fɐʃtɛːɐkuŋ
verstand	fɐʃtɑnt
verstänneg	fɐʃtænəɕ
verstännegkeet	fɐʃtænəɕkeːt
verstauche	fɐʃtæːʊχə
verstauchen	fɐʃtæːʊχən
verstauchung	fɐʃtæːʊχuŋ
verstéiert	fɐʃtɜɪɐt
verstoe	fɐʃtoːə
verstoen	fɐʃtoːən
verstoppe	fɐʃtopə
verstoppen	fɐʃtopən
verstouss	fɐʃtəʊs
verstreeën	fɐʃtʀeən
versuchskanéngche	fɐzuχskɑneŋɕə
versuchskanéngchen	fɐzuχskɑneŋɕən
versuchung	fɐzuːχuŋ
versuerge	fɐzuːɐʑə
versuergen	fɐzuːɐʑən
vertausche	fɐtæːʊʃə
vertauschen	fɐtæːʊʃən
vertraue	fɐtʀɑʊə
vertrauen	fɐtʀɑʊən
vertrieder	fɐtʀiədɐ
veruechtung	fɐuəɕtuŋ
veruerteele	fɐuːɐteːlə
veruerteelen	fɐuːɐteːlən
verwallt	fɐvɑlt
verwalte	fɐvɑltə
verwalten	fɐvɑltən
verwandele	fɐvɑndələ
verwandelen	fɐvɑndələn
verwéckele	fɐvekələ
verwéckelen	fɐvekələn
verweigere	fɐvɑɪʑəʀə
verweigeren	fɐvɑɪʑəʀən
verwieleche	fɐviələɕə
verwielechen	fɐviələɕən
verwiessele	fɐviəsələ
verwiesselen	fɐviəsələn
verwiesslung	fɐviəsluŋ
verwinne	fɐvinə
verwinnen	fɐvinən
verwonnere	fɐvonəʀə
verwonneren	fɐvonəʀən
verwurrele	fɐvuʀələ
verwurrelen	fɐvuʀələn
verzeie	fɐtsɑɪə
verzeien	fɐtsɑɪən
verzichte	fɐtsiɕtə
verzichten	fɐtsiɕtən
verziele	fɐtsiələ
verzielen	fɐtsiələn
verziere	fɐtsiːɐʀə
verzieren	fɐtsiːɐʀən
verzolle	fɐtsolə
verzollen	fɐtsolən
verzweiflung	fɐtswɑɪfluŋ
verzweiwele	fɐtswɑɪvələ
verzweiwelen	fɐtswɑɪvələn
vestiaire	væstjɛːʀ
veterinär	vətəʀinɛːʀ
veterinären	veːtəʀinɛːʀən
veterinärin	vətəʀinɛːʀin
vexéiere	væksɜɪəʀə
vexéieren	væksɜɪəʀən
vidange	vidɑ̃ːʃ
videoscassette	videːoːskɑsæt
viischt	fiːʃt
vijenzeg	fiʒəntsəɕ
vill	fil
villa	vilaː
villche	filɕə
villchen	filɕən
villsäiteg	filzæːɪtəɕ
vinaigrette	vinɛːgʀæt
violett	violæt
virausgesi	fiːʀæːʊsgəzi
virausgesinn	fiːʀæːʊsgəzin
viraussoe	fiːʀæːʊszoːə
viraussoen	fiːʀæːʊszoːən
virbereede	fiːɐbəʀeːdə
virbereeden	fiːɐbəʀeːdən
virbereedung	fiːɐbəʀeːduŋ
virdeel	fiːɐdeːl
virdrun	fiːɐdʀun
virfuere	fiːɐfuːɐʀə
virfueren	fiːɐfuːɐʀən
virgäertche	fiːɐgɛːɐtɕə
virgäertchen	fiːɐgɛːɐtɕən
virgänger	fiːɐgæŋɐ
virgëschter	fiːɐgəʃtɐ
virgesi	fiːɐgəzi
virgesinn	fiːɐgəzin
virgoe	fiːɐgoːə
virgoen	fiːɐgoːən
virgräife	fiːɐgʀæːɪfə
virgräifen	fiːɐgʀæːɪfən
virléift	fiːɐlɜɪft
virnumm	fiːɐnum
virschlag	fiːɐʃlaːχ
virschloe	fiːɐʃloːə
virschloen	fiːɐʃloːən
virsichteg	fiːɐziɕtəɕ
virsprong	fiːɐʃpʀoŋ
virstelle	fiːɐʃtælə
virstellen	fiːɐʃtælən
virstellung	fiːɐʃtæluŋ
virufuere	fiːʀufuːɐʀə
virufueren	fiːʀufuːɐʀən
virugoe	fiːʀugoːə
virugoen	fiːʀugoːən
virun	fiːʀun
virundreiwe	fiːʀundʀɑɪvə
virundreiwen	fiːʀundʀɑɪvən
virus	viːʀus
virwäsch	fiːɐvæʃ
virwerfe	fiːɐvɛʀfə
virwerfen	fiːɐvɛʀfən
virwetz	fiːɐvəts
virwetzeg	fiːɐvətsəɕ
virwetztut	fiːɐvətstuːt
virworf	fiːɐvɔʀf
visàvis	vizaviː
visitekaart	vizitəkaːʀt
vitrin	vitʀin
viz	fiːts
vläicht	flæːɪɕt
voila	vwɑlaː
vokal	vokaːl
voll	fol
vollek	folek
vollekszielung	folekstsiəluŋ
vollert	folɐt
vollkommenheet	folkomənheːt
vrun	fʀun
vu	fu
vue	vyː
vuë	vyːə
vuen	vyːən
vugel	fuʁəl
vulgär	vylgɛːɐ
vulkan	vulkaːn
vulkane	vulkaːnə
vulkanescher	vulkaːnəʃɐ
vulkanescht	vulkaːnəʃt
vull	ful
vullekiischt	fuləkiːʃt
vullenhaische	fulənhɑɪsjə
vullenhaischen	fulənhɑɪsjən
vulleschäich	fuləʃæːɪɕ
vum	fum
vun	fun
wa	vɑ
waache	vaːɕə
waachen	vaːɕən
waakreg	vaːkʀəɕ
waarde	vaːʀdə
waarden	vaːʀdən
waarm	vaːɐm
waarzel	vaːʀtsəl
waasser	vaːsɐ
waasserfaarwe	vaːsɐfaːɐvə
waasserfaarwen	vaːsɐfaːɐvən
waasserfall	vaːsɐfɑl
waasserpouke	vaːsɐpəʊkə
waasserpouken	vaːsɐpəʊkən
waasserschi	vaːsɐʃiː
waasserstee	vaːsɐʃteː
waassersteen	vaːsɐʃteːn
waassertuerm	vaːsɐtuːɐm
wackele	vɑkələ
wackelegem	vɑkələʑəm
wackelegen	vɑkələʑən
wackeleger	vɑkələʑɐ
wackelen	vɑkələn
wäermt	vɛːɐmt
wäertes	vɛːɐtəs
waff	vɑf
wagon	vɑgɑ̃ː
wahlbureaue	vaːlbyʀoːə
wahlbureauen	vaːlbyʀoːən
wahrscheinlech	vaːɐʃɑɪnləɕ
währungsuniounen	vɛːʀuŋsunjəʊnən
wäikeller	væːɪkælɐ
wäin	væːɪn
wäisheetszant	væːɪsheːtstsɑnt
wäiss	væːɪs
wäisslech	væːɪsləɕ
wäit	væːɪt
wäitsichteg	væːɪtsiɕtəɕ
wak	vaːk
wakelter	vaːkəltɐ
wakeregem	vaːkəʀəʑəm
walbureaue	vaːlbyʀoːə
walbureauen	vaːlbyʀoːən
walbüroen	vaːlbyʀoːən
wale	vaːlə
walen	vaːlən
walfësch	vaːlfəʃ
walkampf	vaːlkɑmpf
wallis	vɑlis
walross	vaːlʀos
walz	vɑlts
walziedele	vaːltsiədələ
walziedelen	vaːltsiədələn
wand	vɑnt
wanders	vɑndɐs
wandert	vɑndɐt
wandlunge	vɑndluŋə
wandlungen	vɑndluŋən
wandmille	vɑntmilə
wandmillen	vɑntmilən
wandschaf	vɑntʃaːf
wandstouss	vɑntʃtəʊs
wann	vɑn
wanne	vɑnə
wannen	vɑnən
wanter	vɑntɐ
wanterpneu	vɑntɐpnøː
wantersport	vɑntɐʃpɔʀt
war	vaːʀ
waren	vaːʀən
warndräieck	vɑʀndʀæːɪek
warne	vɑʀnə
warnen	vɑʀnən
warnung	vɑʀnuŋ
warscheinlech	vaːɐʃɑɪnləɕ
wartesall	vɑʀtəzɑl
wärungsuniounen	vɛːʀuŋsunjəʊnən
wäsch	væʃ
wäschanlag	væʃɑnlaːχ
wäschanlage	væʃɑnlaːʁə
waschanlage	vɑʃɑnlaːʁə
wäschbier	væʃbiːɐ
wäsche	væʃə
wäschen	væʃən
wäscherei	væʃəʀɑɪ
wäschkiche	væʃkiɕə
wäschkichen	væʃkiɕən
wäschmaschinn	væʃmɑʃin
wäschpolver	væʃpolfɐ
wasserdicht	vɑsɐdiɕt
wasserleitung	vɑsɐlɑɪtuŋ
wat	vaːt
watt	vɑt
wecker	vækɐ
wee	veː
weeche	veːɕə
weechen	veːɕən
weed	veːt
weekend	wiːkænt
weekendhaischen	wiːkænthɑɪsjən
weekendhaisercher	wiːkænthɑɪzɐɕɐ
weenchen	veːnɕən
weenercher	weːnɐɕɐ
weesekand	veːzəkɑnt
weess	veːs
wéi	vɜɪ
weibche	vɑɪpɕə
weibchen	vɑɪpɕən
weiblech	vɑɪbləɕ
weid	vɑɪt
weide	vɑɪdə
wéidéings	vɜɪdɜɪŋs
wéidéingt	vɜɪdɜɪŋt
weiden	vɑɪdən
weiderentwécklung	vɑɪdɐæntvekluŋ
weiderfuere	vɑɪdɐfuːɐʀə
weiderfueren	vɑɪdɐfuːɐʀən
weidergoe	vɑɪdɐgoːə
weidergoen	vɑɪdɐgoːən
weie	vɑɪə
wéie	vɜɪə
weien	vɑɪən
wéien	vɜɪən
weier	vɑɪɐ
wéimere	vɜɪməʀə
wéimeren	vɜɪməʀən
wéineg	vɜɪnəɕ
wéineger	vɜɪnəʑɐ
wéini	vɜɪniː
wéinst	vɜɪnst
wéinstens	vɜɪnstəns
weis	vɑɪs
weise	vɑɪzə
weisen	vɑɪzən
weit	vɑɪt
wëld	vəlt
well	væl
wëll	vəl
wëlle	vələ
wëllen	vələn
welt	vælt
weltall	vældɑl
weltmeeschterinne	væltmeːʃtəʀinə
weltmeeschterinnen	væltmeːʃtəʀinən
weltmier	væltmiːɐ
weltmierer	væltmiːʀɐ
weltrekord	væltʀəkɔʀt
weltrekorder	væltʀəkɔʀdɐ
weltwonner	væltvonɐ
wëmper	vəmpɐ
wëndel	vəndəl
wéngert	veŋɐt
wénke	veŋkə
wénkel	veŋkəl
wénken	veŋkən
wenne	vænə
wennen	vænən
wënsche	vənʃə
wënschen	vənʃən
werfe	vɛʀfə
werfen	vɛʀfən
wesentlech	veːzəntləɕ
wësse	vəsə
wëssen	vəsən
wëssenschaftler	vəsənʃɑftlɐ
wëssenschaftlerin	vəsənʃɑftləʀin
wëssenschaftlerinne	vəsənʃɑftləʀinə
wëssenschaftlerinnen	vəsənʃɑftləʀinən
weste	væstə
westen	væstən
wett	væt
wette	vætə
wetten	vætən
wetzstee	vætsʃteː
wetzsteen	vætsʃteːn
wibbele	vibələ
wibbeleg	vibələɕ
wibbelegem	vibələʑəm
wibbelegen	vibələʑən
wibbelen	vibələn
wichs	viks
wichsbiischt	viksbiːʃt
wichsbiischten	viksbiːʃtən
wichse	viksə
wichsen	viksən
wichteg	viɕtəɕ
widder	vidɐ
widderhuele	vidɐhuələ
widderhuelen	vidɐhuələn
widderspréchs	vidɐʃpʀəɕs
widdersprécht	vidɐʃpʀəɕt
widderspriech	vidɐʃpʀiəɕ
widdersprieche	vidɐʃpʀiəɕə
widderspriechen	vidɐʃpʀiəɕən
widderstoe	vidɐʃtoːə
widderstoen	vidɐʃtoːən
wie	viə
wieder	viədɐ
wiedere	viədəʀə
wiedereg	viədəʀəɕ
wiederen	viədəʀən
wiel	viəl
wiele	viələ
wielech	viələɕ
wielen	viələn
wiem	viəm
wien	viən
wierdeg	viːɐdəɕ
wiere	viːɐʀə
wieren	viːɐʀən
wierfel	viːɐfəl
wierfele	viːɐfələ
wierfelen	viːɐfələn
wierk	viːɐk
wierkdësch	viːɐkdəʃ
wierke	viːɐkə
wierken	viːɐkən
wierklech	viːɐkləɕ
wierklechkeet	viːɐkləɕkeːt
wierkung	viːɐkuŋ
wierme	viːɐmə
wiermen	viːɐmən
wiermt	viːɐmt
wiers	viːɐs
wiert	viːɐt
wiertchen	viːɐtɕən
wiertes	viːɐtəs
wiertschaft	viːɐtʃɑft
wierze	viːɐtsə
wierzen	viːɐtsən
wiessele	viəsələ
wiesselen	viəsələn
wiewe	viəvə
wiewen	viəvən
wimmele	vimələ
wimmelen	vimələn
wimper	vimpɐ
windjack	vintjɑk
winker	viŋkɐ
winne	vinə
winnen	vinən
wirbelwand	viʀbəlvɑnt
wirschtche	viʀʃtɕə
wirschtchen	viʀʃtɕən
wischer	viʃɐ
wise	viːzə
wisechampignon	viːzəʃɑ̃ːpiɲɑ̃ː
wisechampignone	viːzəʃɑ̃ːpiɲɑ̃ːə
wisechampignonen	viːzəʃɑ̃ːpiɲɑ̃ːən
wisefest	viːzəfæst
wisefester	viːzəfæstɐ
wisel	vizəl
wiss	vis
witfra	vitfʀaː
witmann	vitmɑn
witz	vits
witzeg	vitsəɕ
wo	voː
woch	voχ
woe	voːə
woen	voːən
woll	vol
wollef	voləf
wollek	volek
wollent	volənt
won	voːn
wonn	von
wonner	vonɐ
wonnerbar	vonɐbaːʀ
wonnerbare	vonɐbaːʀə
wonnerbart	vonɐbaːʀt
wonnere	vonəʀə
wonneren	vonəʀən
wonnerschéin	vonɐʃɜɪn
wonnerwierk	vonɐviːɐk
wonsch	vonʃ
woodlech	voːdləɕ
wope	voːp
wopen	voːpən
wopendéier	voːpəndɜɪɐ
wopendéiere	voːpəndɜɪəʀə
wopendéieren	voːpəndɜɪəʀən
wou	vəʊ
wouduerjer	vəʊduːɐʑɐ
wouer	vəʊɐ
wouerecht	vəʊəʀəɕt
woumadder	vəʊmɑdɐ
woumat	vəʊmɑt
wourënner	vəʊʀənɐ
wourun	vəʊʀun
wouscht	vəʊʃt
wouvun	vəʊfun
wrack	vʀɑk
wuecht	vuəɕt
wued	vuət
wuel	vuəl
wuer	vuːɐ
wuerfir	vuːɐfiːɐ
wuergéint	vuːɐgɜɪnt
wuerhin	vuːɐhin
wuerm	vuːɐm
wuert	vuːɐt
wuerzel	vuːɐtsəl
wues	vuəs
wuesse	vuəsə
wuessen	vuəsən
wuesskräijonge	vuəskʀæːɪjoŋə
wuesskräijongen	vuəskʀæːɪjoŋən
wuesstem	vuəstəm
wull	vul
wunne	vunə
wunnen	vunən
wunneng	vuneŋ
wupp	vup
wurscht	vuʀʃt
wüst	vyːst
xenophobem	kseːnoːfoːbəm
xenophoben	kseːnoːfoːbən
xenophober	kseːnoːfoːbɐ
xenophobie	kseːnoːfoːbiː
xenophobt	kseːnoːfoːpt
xylofon	ksiloːfoːn
xylofone	ksiloːfoːnə
xylofonen	ksiloːfoːnən
xylofoner	ksiloːfonɐ
xylophon	ksiloːfoːn
xylophone	ksiloːfoːnə
xylophonen	ksiloːfoːnən
xylophoner	ksiloːfoːnɐ
yoga	joːgaː
yoghourt	joguʀt
zaang	tsaːŋ
zaart	tsaːʀt
zack	tsɑk
zäertlech	tsɛːɐtləɕ
zäertlechkeet	tsɛːɐtləɕkeːt
zahnstocher	tsaːnʃtoχɐ
zäit	tsæːɪt
zäitgenëssesch	tsæːɪtgənəsəʃ
zäitschrëft	tsæːɪtʃʀəft
zäitweileg	tsæːɪtvɑɪləɕ
zalot	tsɑloːt
zam	tsaːm
zäme	tsɛːmə
zämen	tsɛːmən
zammermann	tsɑmɐmɑn
zännbiischt	tsænbiːʃt
zänndokter	tsændoktɐ
zännfleesch	tsænfleːʃ
zännpasta	tsænpɑstaː
zännseef	tsænzeːf
zännstëppler	tsænʃtəplɐ
zännwéi	tsænwɜɪ
zant	tsɑnt
zanter	tsɑntɐ
zantimeter	tsɑntimeːtɐ
zap	tsaːp
zape	tsaːpə
zapen	tsaːpən
zappe	tsɑpə
zappen	tsɑpən
zär	tsɛːɐ
zare	tsaːʀə
zäsure	tsɛːsuːʀə
zäsuren	tsɛːzuːʀən
zaubere	tsɑʊbəʀə
zauberei	tsɑʊbəʀɑɪ
zauberen	tsɑʊbəʀən
ze	zə
zebra	tseːbʀaː
zebrasträif	tseːbʀaːstʀæːɪf
zecke	tsækə
zécke	tsekə
zecken	tsækən
zécken	tsekən
zeder	tseːdɐ
zee	tseː
zeeche	tseːɕə
zeechen	tseːɕən
zeechne	tseːɕnə
zeechnen	tseːɕnən
zeechner	tseːɕnɐ
zeechnerin	tseːɕnəʀin
zeechnung	tseːɕnuŋ
zeen	tseːn
zefridde	tsəfʀidə
zefridden	tsəfʀidən
zeideg	tsɑɪdəɕ
zeie	tsɑɪə
zéie	tsɜɪə
zeien	tsɑɪən
zéien	tsɜɪən
zéif	tsɜɪf
zeitung	tsɑɪtuŋ
zejoer	tsəjoɐ
zejoert	tsəjoːɐt
zelebréiert	tselebʀɜɪɐt
zelleri	tsæləʀiː
zelt	tsælt
zement	tsəmænt
zëmmer	tsəmɐ
zemol	tsəmoːl
zemools	tsəmoːls
zéng	tseŋ
zéngte	tseŋtə
zéngten	tseŋtən
zënn	tsən
zensur	tsænzuːʀ
zensure	tsænzuːʀə
zensuren	tsænzuːʀən
zënter	tsəntɐ
zentral	tsæntʀaːl
zentrifugal	tsæntʀifuːgaːl
zentrifugale	tsæntʀifuːgaːlə
zentrifugalem	tsæntʀifuːgaːləm
zentrifugalen	tsæntʀifuːgaːlən
zentrifugaler	tsæntʀifuːgaːlɐ
zentrifugéierter	tsæntʀifuːgɜɪɐtɐ
zentrifugen	tsæntʀifuːʁən
zentrum	tsæntʀum
zerbrieche	tsɐbʀiəɕə
zerbriechen	tsɐbʀiəɕən
zerbriechlech	tsɐbʀiəɕləɕ
zerdrécke	tsɐdʀekə
zerdrécken	tsɐdʀekən
zeremonie	tseʀemoniː
zeremonië	tseʀemoniːə
zeremonien	tseʀemoniːən
zerfatzt	tsɐfɑtst
zeriet	tsəʀiət
zerkniwwele	tsɐknivələ
zerkniwwelen	tsɐknivələn
zerkraazt	tsɐkʀaːtst
zermuele	tsɐmuələ
zermuelen	tsɐmuələn
zerquetsche	tsɐkwætʃə
zerquetschen	tsɐkwætʃən
zerräisse	tsɐʀæːɪsə
zerräissen	tsɐʀæːɪsən
zerrappe	tsɐʀɑpə
zerrappen	tsɐʀɑpən
zersaten	tsɐzaːtən
zersater	tsɐzaːtɐ
zerschloe	tsɐʃloːə
zerschloen	tsɐʃloːən
zerseetem	tsɐzeːtəm
zerseeten	tsɐzeːtən
zerseeter	tsɐzeːtɐ
zersidelt	tsɐziːdəlt
zersidelte	tsɐziːdəltə
zersideltem	tsɐzidəltəm
zerstéiere	tsɐʃtɜɪəʀə
zerstéieren	tsɐʃtɜɪəʀən
zerstreet	tsɐʃtʀeːt
zertéitschter	tsɐtɜɪtʃtɐ
zertifika	tsɛʀtifikaː
zertifikat	tsɛʀtifikaːt
zertifikater	tsɛʀtifikaːtɐ
zerwéiere	tsɛʀvɜɪəʀə
zerwéieren	tsɛʀvɜɪəʀən
zerwéit	tsɛʀvɜɪt
zerwiss	tsɛʀvis
zerwisser	tsɛʀvisɐ
zerwujel	tsɐvuʑəl
zerwujele	tsɐvuʑələ
zerwujelen	tsɐvuʑələn
zerwujels	tsɐvuʑəls
zerwullte	tsɐvultə
zerwulltem	tsɐvultəm
zerwullten	tsɐvultən
zerwullter	tsɐvultɐ
zësse	tsəsə
zëssen	tsəsən
zesumme	tsəzumə
zesummebrieche	tsəzuməbʀiəɕə
zesummebriechen	tsəzuməbʀiəɕən
zesummegepecht	tsəzuməgəpæɕt
zesummegepechte	tsəzuməgəpæɕtə
zesummen	tsəzumən
zesummepeche	tsəzuməpæɕə
zesummepechen	tsəzuməpæɕən
zesummeschäre	tsəzuməʃɛːʀə
zesummeschären	tsəzuməʃɛːʀən
zesummesetze	tsəzuməzætsə
zesummesetzen	tsəzuməzætsən
zetär	tsətɛːʀ
zevirkoums	tsəfiːɐkəʊms
zevirkoumt	tsəfiːɐkəʊmt
zevirzekomme	tsəfiːɐtsəkomə
zevirzekommen	tsəfiːɐtsəkomən
ziddere	tsidəʀə
zidderen	tsidəʀən
ziedel	tsiədəl
ziele	tsiələ
zielen	tsiələn
zierkel	tsiːɐkəl
ziffer	tsifɐ
zifferblat	tsifɐblaːt
zigar	tsigaːʀ
zigare	tsigaːʀ
zigaren	tsigaːʀən
zigarett	tsigɑʀæt
zigel	tsiʑəl
ziicht	tsiːɕt
ziichte	tsiːɕtə
ziichten	tsiːɕtən
zil	tsiːl
zill	tsil
zille	tsilə
zillen	tsilən
zilscheif	tsiːlʃɑɪf
zimlech	tsimləɕ
zinema	tsinemaː
zinnober	tsinoːbɐ
zirkuléiere	tsiʀkulɜɪəʀə
zirkuléieren	tsiʀkulɜɪəʀən
zirkus	tsiʀkus
zitadell	tsitɑdæl
zitadelle	tsitɑdælə
zitadellen	tsitɑdælən
zitéiere	tsitɜɪəʀə
zitéieren	tsitɜɪəʀən
zitroun	tsitʀəʊn
zivilsten	tsivilstən
zivilster	tsivilstɐ
zivilt	tsivilt
ziwwi	tsiviː
ziwwie	tsiviːə
zocker	tsokɐ
zockerboun	tsokɐbəʊn
zockerdëppche	tsokɐdəpɕə
zockerdëppchen	tsokɐdəpɕən
zockerwatt	tsokɐvɑt
zodi	tsoːdiː
zolidd	tsolit
zomm	tsom
zon	tsoːn
zone	tsoːnə
zonen	tsoːnən
zong	tsoŋ
zoo	tsoː
zooen	tsoːən
zoolog	tsoːloːk
zoologe	tsoːloːgə
zoologen	tsoːloːgən
zoologin	tsoːloːgin
zoologinne	tsoːoːloːginə
zoologinnen	tsoːoːloːginən
zoom	zuːm
zoome	zuːmə
zoomen	zuːmən
zooms	zuːms
zoomt	zuːmt
zooss	tsoːs
zoossiss	tsoːsis
zopp	tsop
zoppeläffel	tsopəlæfəl
zort	tsɔʀt
zou	tsəʊ
zoudecke	tsəʊdækə
zoudecken	tsəʊdækən
zoudréie	tsəʊdʀɜɪə
zoudréien	tsəʊdʀɜɪən
zoufall	tsəʊfɑl
zoufälleg	tsəʊfæləɕ
zougänglech	tsəʊgæŋləɕ
zougank	tsəʊgɑŋk
zougestoe	tsəʊgəʃtoːə
zougestoen	tsəʊgəʃtoːən
zougi	tsəʊgi
zouginn	tsəʊgin
zouhuele	tsəʊhuələ
zouhuelen	tsəʊhuələn
zoukënfteg	tsəʊkənftəɕ
zouknäppe	tsəʊknæpə
zouknäppen	tsəʊknæpən
zoulaf	tsəʊlaːf
zoulag	tsəʊlaːχ
zouléisseg	tsəʊlɜɪsəɕ
zousätzlech	tsəʊzætsləɕ
zouso	tsəʊsoː
zouspäre	tsəʊʃpɛːʀə
zouspären	tsəʊʃpɛːʀən
zoustand	tsəʊʃtɑnt
zouverléisseg	tsəʊfɐlɜɪsəɕ
zrass	tsʀɑs
zréck	tsʀek
zréckbezuele	tsʀekbetsuələ
zréckbezuelen	tsʀekbetsuələn
zréckgi	tsʀekgi
zréckginn	tsʀekgin
zréckkomme	tsʀekkomə
zréckkommen	tsʀekkomən
zréckkréie	tsʀekkʀɜɪə
zréckkréien	tsʀekkʀɜɪən
zréckschécke	tsʀekʃekə
zréckschécken	tsʀekʃekən
zrécksprange	tsʀekʃpʀɑŋə
zrécksprangen	tsʀekʃpʀɑŋən
zrécktriede	tsʀektʀiədə
zrécktrieden	tsʀektʀiədən
zréckzéie	tsʀektsɜɪə
zréckzéien	tsʀektsɜɪən
zuch	tsuχ
zuel	tsuəl
zukënfteg	tsuːkənftəɕ
zukunft	tsuːkunft
zündung	tsynduŋ
zwang	tswɑŋ
zwanzeg	tswɑntsəɕ
zwar	tswaːʀ
zweck	tswæk
zwee	tsweː
zweeasechzeg	tsweːɑzæɕtsəɕ
zweedeiteg	tsweːdɑɪtəɕ
zweeeeëg	tsweːeːəɕ
zweemol	tsweːmoːl
zweete	tsweːtə
zweeten	tsweːtən
zweetrangeg	tsweːtʀɑŋəɕ
zwéin	tswɜɪn
zweiwel	tswɑɪvəl
zweiwele	tswɑɪvələ
zweiwelen	tswɑɪvələn
zweiwelhaft	tswɑɪvəlhɑft
zwénge	tsweŋə
zwéngen	tsweŋən
zwerg	tswɛʀɕ
zwerge	tswɛʀɕə
zwergen	tswɛʀʑən
zwëschefall	tswəʃəfɑl
zwëschegelant	tswəʃəgəlɑnt
zwielef	tswiələf
zwillinge	tswiliŋə
zwillingen	tswiliŋən
zwir	tswiːɐ
zwire	tswiːʀə
zwiren	tswiːʀən
zwirer	tswiːʀɐ
zwispältegen	tswiːʃpæltəʑən
zwispältegster	tswiːʃpæltəɕstɐ
zwispältegt	tswiːʃpæltəɕt
zwiwwel	tswivəl
zwou	tswəʊ
zykle	tsikəl
zyklen	tsiklən
zyklesch	tsikləʃ
zykleschen	tsikləʃən
zyklescher	tsikləʃɐ
zyklescht	tsikləʃt
zyklus	tsiklus
zyklusse	tsiklusə
zyklussen	tsiklusən
zylinder	tsilindɐ
zynesch	tsiːnəʃ
zynescht	tsiːnəʃt
zyniker	tsiːnikɐ
zynikerin	tsiːnikəʀin
zynikerinne	tsiːnikəʀinə
zynikerinnen	tsiːnikəʀinən
zynismus	tsinismus
zypress	tsipʀæs
zypriot	tsipʀioːt
